0x1BF21730, 37561850161119240, 66368853, 66369376, 523, 640x360 
0x1BF21730, 37561850161758072, 66369398, 66369420, 22, 640x360 
0x1BF21730, 37561850166712712, 66369420, 66369435, 15, 640x360 
0x1BF21730, 37561850167032864, 66369442, 66369446, 4, 640x360 
0x1BF21730, 37561850167352840, 66369477, 66369481, 4, 640x360 
0x1BF21730, 37561850167673440, 66369506, 66369509, 3, 640x360 
0x1BF21730, 37561850168152664, 66369553, 66369556, 3, 640x360 
0x1BF21730, 37561850168472776, 66369590, 66369593, 3, 640x360 
0x1BF21730, 37561850168793736, 66369620, 66369623, 3, 640x360 
0x1BF21730, 37561850169116472, 66369649, 66369652, 3, 640x360 
0x1BF21730, 37561850169436464, 66369684, 66369687, 3, 640x360 
0x1BF21730, 37561850169756528, 66369713, 66369717, 4, 640x360 
0x1BF21730, 37561850170072968, 66369748, 66369753, 5, 640x360 
0x1BF21730, 37561850170393368, 66369778, 66369782, 4, 640x360 
0x1BF21730, 37561850170713840, 66369813, 66369820, 7, 640x360 
0x1BF21730, 37561850171033576, 66369843, 66369847, 4, 640x360 
0x1BF21730, 37561850171353344, 66369878, 66369882, 4, 640x360 
0x1BF21730, 37561850171673048, 66369907, 66369910, 3, 640x360 
0x1BF21730, 37561850171993008, 66369936, 66369939, 3, 640x360 
0x1BF21730, 37561850172472960, 66369984, 66369988, 4, 640x360 
0x1BF21730, 37561850172792992, 66370020, 66370024, 4, 640x360 
0x1BF21730, 37561850173115768, 66370049, 66370052, 3, 640x360 
0x1BF21730, 37561850173435880, 66370085, 66370088, 3, 640x360 
0x1BF21730, 37561850173758624, 66370115, 66370118, 3, 640x360 
0x1BF21730, 37561850174074000, 66370149, 66370153, 4, 640x360 
0x1BF21730, 37561850174392968, 66370179, 66370183, 4, 640x360 
0x1BF21730, 37561850174713120, 66370214, 66370220, 6, 640x360 
0x1BF21730, 37561850175033760, 66370242, 66370245, 3, 640x360 
0x1BF21730, 37561850175353392, 66370276, 66370280, 4, 640x360 
0x1BF21730, 37561850175674312, 66370307, 66370310, 3, 640x360 
0x1BF21730, 37561850175993288, 66370337, 66370340, 3, 640x360 
0x1BF21730, 37561850176314008, 66370371, 66370374, 3, 640x360 
0x1BF21730, 37561850176793440, 66370422, 66370425, 3, 640x360 
0x1BF21730, 37561850177114528, 66370450, 66370453, 3, 640x360 
0x1BF21730, 37561850177437568, 66370485, 66370488, 3, 640x360 
0x1BF21730, 37561850177757088, 66370514, 66370518, 4, 640x360 
0x1BF21730, 37561850178073896, 66370550, 66370554, 4, 640x360 
0x1BF21730, 37561850178393232, 66370578, 66370582, 4, 640x360 
0x1BF21730, 37561850178713032, 66370613, 66370617, 4, 640x360 
0x1BF21730, 37561850179033160, 66370645, 66370650, 5, 640x360 
0x1BF21730, 37561850179353144, 66370674, 66370678, 4, 640x360 
0x1BF21730, 37561850179674336, 66370709, 66370713, 4, 640x360 
0x1BF21730, 37561850179993040, 66370739, 66370742, 3, 640x360 
0x1BF21730, 37561850180314960, 66370774, 66370777, 3, 640x360 
0x1BF21730, 37561850180633464, 66370803, 66370806, 3, 640x360 
0x1BF21730, 37561850181113640, 66370850, 66370853, 3, 640x360 
0x1BF21730, 37561850181435184, 66370884, 66370887, 3, 640x360 
0x1BF21730, 37561850181756888, 66370914, 66370918, 4, 640x360 
0x1BF21730, 37561850182074080, 66370949, 66370954, 5, 640x360 
0x1BF21730, 37561850182393728, 66370978, 66370986, 8, 640x360 
0x1BF21730, 37561850182713480, 66371012, 66371016, 4, 640x360 
0x1BF21730, 37561850183033600, 66371046, 66371050, 4, 640x360 
0x1BF21730, 37561850183353744, 66371074, 66371078, 4, 640x360 
0x1BF21730, 37561850183674144, 66371109, 66371113, 4, 640x360 
0x1BF21730, 37561850183993144, 66371137, 66371140, 3, 640x360 
0x1BF21730, 37561850184312816, 66371171, 66371174, 3, 640x360 
0x1BF21730, 37561850184633128, 66371204, 66371207, 3, 640x360 
0x1BF21730, 37561850184953240, 66371233, 66371236, 3, 640x360 
0x1BF21730, 37561850185433296, 66371284, 66371287, 3, 640x360 
0x1BF21730, 37561850185754952, 66371315, 66371319, 4, 640x360 
0x1BF21730, 37561850186073264, 66371350, 66371353, 3, 640x360 
0x1BF21730, 37561850186393560, 66371380, 66371386, 6, 640x360 
0x1BF21730, 37561850186713120, 66371414, 66371420, 6, 640x360 
0x1BF21730, 37561850187033400, 66371442, 66371446, 4, 640x360 
0x1BF21730, 37561850187353160, 66371476, 66371480, 4, 640x360 
0x1BF21730, 37561850187673184, 66371505, 66371508, 3, 640x360 
0x1BF21730, 37561850187993440, 66371540, 66371543, 3, 640x360 
0x1BF21730, 37561850188313792, 66371570, 66371573, 3, 640x360 
0x1BF21730, 37561850188633200, 66371603, 66371607, 4, 640x360 
0x1BF21730, 37561850188953256, 66371638, 66371641, 3, 640x360 
0x1BF21730, 37561850189275392, 66371668, 66371671, 3, 640x360 
0x1BF21730, 37561850189753496, 66371714, 66371718, 4, 640x360 
0x1BF21730, 37561850190074128, 66371749, 66371753, 4, 640x360 
0x1BF21730, 37561850190393040, 66371777, 66371785, 8, 640x360 
0x1BF21730, 37561850190714024, 66371813, 66371840, 27, 640x360 
0x1BF21730, 37561850191041760, 66371844, 66371848, 4, 640x360 
0x1BF21730, 37561850191353096, 66371873, 66371876, 3, 640x360 
0x1BF21730, 37561850191673760, 66371908, 66371911, 3, 640x360 
0x1BF21730, 37561850191994400, 66371937, 66371941, 4, 640x360 
0x1BF21730, 37561850192313576, 66371972, 66371975, 3, 640x360 
0x1BF21730, 37561850192633120, 66372006, 66372009, 3, 640x360 
0x1BF21730, 37561850192953336, 66372035, 66372038, 3, 640x360 
0x1BF21730, 37561850193275224, 66372064, 66372068, 4, 640x360 
0x1BF21730, 37561850193598080, 66372099, 66372103, 4, 640x360 
0x1BF21730, 37561850194073416, 66372146, 66372149, 3, 640x360 
0x1BF21730, 37561850194393112, 66372181, 66372186, 5, 640x360 
0x1BF21730, 37561850194712952, 66372208, 66372212, 4, 640x360 
0x1BF21730, 37561850195033088, 66372244, 66372253, 9, 640x360 
0x1BF21730, 37561850195353240, 66372273, 66372277, 4, 640x360 
0x1BF21730, 37561850195673160, 66372307, 66372310, 3, 640x360 
0x1BF21730, 37561850195992800, 66372337, 66372340, 3, 640x360 
0x1BF21730, 37561850196313888, 66372372, 66372375, 3, 640x360 
0x1BF21730, 37561850196633552, 66372401, 66372405, 4, 640x360 
0x1BF21730, 37561850196953056, 66372435, 66372438, 3, 640x360 
0x1BF21730, 37561850197492144, 66372492, 66372496, 4, 640x360 
0x1BF21730, 37561850197594824, 66372499, 66372506, 7, 640x360 
0x1BF21730, 37561850197913528, 66372534, 66372537, 3, 640x360 
0x1BF21730, 37561850198392920, 66372581, 66372585, 4, 640x360 
0x1BF21730, 37561850198713480, 66372610, 66372615, 5, 640x360 
0x1BF21730, 37561850199033184, 66372645, 66372648, 3, 640x360 
0x1BF21730, 37561850199352992, 66372674, 66372677, 3, 640x360 
0x1BF21730, 37561850199672928, 66372706, 66372709, 3, 640x360 
0x1BF21730, 37561850199992976, 66372741, 66372745, 4, 640x360 
0x1BF21730, 37561850200313512, 66372771, 66372774, 3, 640x360 
0x1BF21730, 37561850200633584, 66372805, 66372808, 3, 640x360 
0x1BF21730, 37561850200953488, 66372835, 66372838, 3, 640x360 
0x1BF21730, 37561850201273968, 66372866, 66372869, 3, 640x360 
0x1BF21730, 37561850201598168, 66372901, 66372905, 4, 640x360 
0x1BF21730, 37561850201917848, 66372935, 66372938, 3, 640x360 
0x1BF21730, 37561850202234112, 66372963, 66372969, 6, 640x360 
0x1BF21730, 37561850202713544, 66373010, 66373014, 4, 640x360 
0x1BF21730, 37561850203033008, 66373045, 66373049, 4, 640x360 
0x1BF21730, 37561850203352976, 66373073, 66373077, 4, 640x360 
0x1BF21730, 37561850203697216, 66373127, 66373131, 4, 640x360 
0x1BF21730, 37561850203999192, 66373139, 66373142, 3, 640x360 
0x1BF21730, 37561850204314376, 66373173, 66373176, 3, 640x360 
0x1BF21730, 37561850204633400, 66373203, 66373205, 2, 640x360 
0x1BF21730, 37561850204953168, 66373232, 66373235, 3, 640x360 
0x1BF21730, 37561850205275120, 66373268, 66373272, 4, 640x360 
0x1BF21730, 37561850205597928, 66373298, 66373301, 3, 640x360 
0x1BF21730, 37561850205920216, 66373333, 66373336, 3, 640x360 
0x1BF21730, 37561850206233960, 66373362, 66373368, 6, 640x360 
0x1BF21730, 37561850206552976, 66373397, 66373402, 5, 640x360 
0x1BF21730, 37561850207032992, 66373442, 66373446, 4, 640x360 
0x1BF21730, 37561850207353072, 66373476, 66373482, 6, 640x360 
0x1BF21730, 37561850207673136, 66373505, 66373508, 3, 640x360 
0x1BF21730, 37561850207993184, 66373539, 66373542, 3, 640x360 
0x1BF21730, 37561850208313360, 66373568, 66373571, 3, 640x360 
0x1BF21730, 37561850208633232, 66373602, 66373606, 4, 640x360 
0x1BF21730, 37561850208952744, 66373636, 66373639, 3, 640x360 
0x1BF21730, 37561850209275792, 66373664, 66373668, 4, 640x360 
0x1BF21730, 37561850209598104, 66373699, 66373703, 4, 640x360 
0x1BF21730, 37561850209917808, 66373734, 66373738, 4, 640x360 
0x1BF21730, 37561850210233872, 66373762, 66373767, 5, 640x360 
0x1BF21730, 37561850210552904, 66373797, 66373804, 7, 640x360 
0x1BF21730, 37561850211352736, 66373873, 66373876, 3, 640x360 
0x1BF21730, 37561850211672520, 66373907, 66373910, 3, 640x360 
0x1BF21730, 37561850211993912, 66373942, 66373946, 4, 640x360 
0x1BF21730, 37561850212313424, 66373970, 66373973, 3, 640x360 
0x1BF21730, 37561850212634184, 66374006, 66374009, 3, 640x360 
0x1BF21730, 37561850212952920, 66374035, 66374039, 4, 640x360 
0x1BF21730, 37561850213275640, 66374069, 66374073, 4, 640x360 
0x1BF21730, 37561850213598464, 66374098, 66374102, 4, 640x360 
0x1BF21730, 37561850213918328, 66374131, 66374135, 4, 640x360 
0x1BF21730, 37561850214233976, 66374165, 66374169, 4, 640x360 
0x1BF21730, 37561850214552960, 66374192, 66374196, 4, 640x360 
0x1BF21730, 37561850214872904, 66374226, 66374230, 4, 640x360 
0x1BF21730, 37561850215193280, 66374260, 66374264, 4, 640x360 
0x1BF21730, 37561850215673568, 66374308, 66374312, 4, 640x360 
0x1BF21730, 37561850215993080, 66374337, 66374340, 3, 640x360 
0x1BF21730, 37561850216312944, 66374371, 66374374, 3, 640x360 
0x1BF21730, 37561850216633056, 66374401, 66374404, 3, 640x360 
0x1BF21730, 37561850216953216, 66374435, 66374438, 3, 640x360 
0x1BF21730, 37561850217275424, 66374469, 66374472, 3, 640x360 
0x1BF21730, 37561850217597184, 66374497, 66374500, 3, 640x360 
0x1BF21730, 37561850217919672, 66374531, 66374535, 4, 640x360 
0x1BF21730, 37561850218234104, 66374560, 66374568, 8, 640x360 
0x1BF21730, 37561850218552960, 66374594, 66374598, 4, 640x360 
0x1BF21730, 37561850218872560, 66374627, 66374632, 5, 640x360 
0x1BF21730, 37561850219192928, 66374662, 66374667, 5, 640x360 
0x1BF21730, 37561850219513200, 66374691, 66374695, 4, 640x360 
0x1BF21730, 37561850219992896, 66374738, 66374741, 3, 640x360 
0x1BF21730, 37561850220313112, 66374772, 66374775, 3, 640x360 
0x1BF21730, 37561850220634256, 66374802, 66374805, 3, 640x360 
0x1BF21730, 37561850220954000, 66374837, 66374840, 3, 640x360 
0x1BF21730, 37561850221273904, 66374865, 66374868, 3, 640x360 
0x1BF21730, 37561850221595616, 66374902, 66374905, 3, 640x360 
0x1BF21730, 37561850221917768, 66374930, 66374933, 3, 640x360 
0x1BF21730, 37561850222234056, 66374960, 66374968, 8, 640x360 
0x1BF21730, 37561850222552592, 66374995, 66374999, 4, 640x360 
0x1BF21730, 37561850222872520, 66375024, 66375028, 4, 640x360 
0x1BF21730, 37561850223192984, 66375058, 66375062, 4, 640x360 
0x1BF21730, 37561850223513376, 66375093, 66375097, 4, 640x360 
0x1BF21730, 37561850223833016, 66375124, 66375127, 3, 640x360 
0x1BF21730, 37561850224313040, 66375171, 66375174, 3, 640x360 
0x1BF21730, 37561850224633056, 66375200, 66375203, 3, 640x360 
0x1BF21730, 37561850224953168, 66375234, 66375237, 3, 640x360 
0x1BF21730, 37561850225274824, 66375270, 66375273, 3, 640x360 
0x1BF21730, 37561850225597048, 66375298, 66375301, 3, 640x360 
0x1BF21730, 37561850225917000, 66375331, 66375334, 3, 640x360 
0x1BF21730, 37561850226233896, 66375367, 66375372, 5, 640x360 
0x1BF21730, 37561850226554240, 66375396, 66375402, 6, 640x360 
0x1BF21730, 37561850226873200, 66375425, 66375429, 4, 640x360 
0x1BF21730, 37561850227192928, 66375459, 66375463, 4, 640x360 
0x1BF21730, 37561850227513264, 66375489, 66375492, 3, 640x360 
0x1BF21730, 37561850227832912, 66375524, 66375527, 3, 640x360 
0x1BF21730, 37561850228633160, 66375601, 66375604, 3, 640x360 
0x1BF21730, 37561850228953240, 66375637, 66375640, 3, 640x360 
0x1BF21730, 37561850229280016, 66375666, 66375669, 3, 640x360 
0x1BF21730, 37561850229596680, 66375700, 66375704, 4, 640x360 
0x1BF21730, 37561850229919760, 66375734, 66375737, 3, 640x360 
0x1BF21730, 37561850230233216, 66375762, 66375768, 6, 640x360 
0x1BF21730, 37561850230552928, 66375797, 66375803, 6, 640x360 
0x1BF21730, 37561850230873616, 66375826, 66375830, 4, 640x360 
0x1BF21730, 37561850231193128, 66375862, 66375866, 4, 640x360 
0x1BF21730, 37561850231513200, 66375891, 66375894, 3, 640x360 
0x1BF21730, 37561850231832880, 66375925, 66375928, 3, 640x360 
0x1BF21730, 37561850232155344, 66375954, 66375957, 3, 640x360 
0x1BF21730, 37561850232473256, 66375990, 66375993, 3, 640x360 
0x1BF21730, 37561850232954328, 66376038, 66376041, 3, 640x360 
0x1BF21730, 37561850233273192, 66376066, 66376069, 3, 640x360 
0x1BF21730, 37561850233598568, 66376102, 66376105, 3, 640x360 
0x1BF21730, 37561850233920128, 66376132, 66376135, 3, 640x360 
0x1BF21730, 37561850234233800, 66376161, 66376168, 7, 640x360 
0x1BF21730, 37561850234552704, 66376196, 66376200, 4, 640x360 
0x1BF21730, 37561850234873208, 66376225, 66376229, 4, 640x360 
0x1BF21730, 37561850235193168, 66376259, 66376263, 4, 640x360 
0x1BF21730, 37561850235513608, 66376294, 66376298, 4, 640x360 
0x1BF21730, 37561850235833264, 66376322, 66376325, 3, 640x360 
0x1BF21730, 37561850236153136, 66376354, 66376357, 3, 640x360 
0x1BF21730, 37561850236473720, 66376389, 66376393, 4, 640x360 
0x1BF21730, 37561850236793184, 66376419, 66376422, 3, 640x360 
0x1BF21730, 37561850237272632, 66376467, 66376470, 3, 640x360 
0x1BF21730, 37561850237595808, 66376502, 66376505, 3, 640x360 
0x1BF21730, 37561850237918312, 66376531, 66376535, 4, 640x360 
0x1BF21730, 37561850238234864, 66376564, 66376568, 4, 640x360 
0x1BF21730, 37561850238553416, 66376594, 66376598, 4, 640x360 
0x1BF21730, 37561850238873072, 66376628, 66376632, 4, 640x360 
0x1BF21730, 37561850239193080, 66376657, 66376660, 3, 640x360 
0x1BF21730, 37561850239513328, 66376691, 66376694, 3, 640x360 
0x1BF21730, 37561850239833312, 66376726, 66376730, 4, 640x360 
0x1BF21730, 37561850240152880, 66376755, 66376758, 3, 640x360 
0x1BF21730, 37561850240473392, 66376786, 66376789, 3, 640x360 
0x1BF21730, 37561850240794720, 66376822, 66376825, 3, 640x360 
0x1BF21730, 37561850241114144, 66376851, 66376854, 3, 640x360 
0x1BF21730, 37561850241594096, 66376901, 66376905, 4, 640x360 
0x1BF21730, 37561850241915752, 66376931, 66376934, 3, 640x360 
0x1BF21730, 37561850242233728, 66376967, 66376972, 5, 640x360 
0x1BF21730, 37561850242553544, 66376997, 66377003, 6, 640x360 
0x1BF21730, 37561850242873088, 66377026, 66377030, 4, 640x360 
0x1BF21730, 37561850243193128, 66377060, 66377064, 4, 640x360 
0x1BF21730, 37561850243513200, 66377089, 66377092, 3, 640x360 
0x1BF21730, 37561850243833656, 66377124, 66377127, 3, 640x360 
0x1BF21730, 37561850244153584, 66377153, 66377156, 3, 640x360 
0x1BF21730, 37561850244473232, 66377188, 66377191, 3, 640x360 
0x1BF21730, 37561850244793424, 66377222, 66377225, 3, 640x360 
0x1BF21730, 37561850245113256, 66377251, 66377255, 4, 640x360 
0x1BF21730, 37561850245437624, 66377287, 66377290, 3, 640x360 
0x1BF21730, 37561850245913336, 66377329, 66377332, 3, 640x360 
0x1BF21730, 37561850246233408, 66377364, 66377368, 4, 640x360 
0x1BF21730, 37561850246553664, 66377393, 66377397, 4, 640x360 
0x1BF21730, 37561850246873520, 66377430, 66377434, 4, 640x360 
0x1BF21730, 37561850247193320, 66377460, 66377464, 4, 640x360 
0x1BF21730, 37561850247514680, 66377490, 66377493, 3, 640x360 
0x1BF21730, 37561850247834048, 66377524, 66377528, 4, 640x360 
0x1BF21730, 37561850248153504, 66377554, 66377557, 3, 640x360 
0x1BF21730, 37561850248473520, 66377584, 66377587, 3, 640x360 
0x1BF21730, 37561850248793208, 66377618, 66377621, 3, 640x360 
0x1BF21730, 37561850249114544, 66377653, 66377656, 3, 640x360 
0x1BF21730, 37561850249437560, 66377685, 66377688, 3, 640x360 
0x1BF21730, 37561850249758464, 66377719, 66377722, 3, 640x360 
0x1BF21730, 37561850250234104, 66377760, 66377767, 7, 640x360 
0x1BF21730, 37561850250553056, 66377796, 66377800, 4, 640x360 
0x1BF21730, 37561850250872632, 66377825, 66377834, 9, 640x360 
0x1BF21730, 37561850251193928, 66377862, 66377868, 6, 640x360 
0x1BF21730, 37561850251513536, 66377891, 66377895, 4, 640x360 
0x1BF21730, 37561850251832976, 66377921, 66377925, 4, 640x360 
0x1BF21730, 37561850252153848, 66377956, 66377959, 3, 640x360 
0x1BF21730, 37561850252473184, 66377985, 66377988, 3, 640x360 
0x1BF21730, 37561850252793888, 66378020, 66378024, 4, 640x360 
0x1BF21730, 37561850253112872, 66378050, 66378053, 3, 640x360 
0x1BF21730, 37561850253433944, 66378084, 66378087, 3, 640x360 
0x1BF21730, 37561850253754792, 66378113, 66378121, 8, 640x360 
0x1BF21730, 37561850254078568, 66378149, 66378154, 5, 640x360 
0x1BF21730, 37561850254553408, 66378196, 66378204, 8, 640x360 
0x1BF21730, 37561850254873400, 66378229, 66378233, 4, 640x360 
0x1BF21730, 37561850255193784, 66378258, 66378265, 7, 640x360 
0x1BF21730, 37561850255513416, 66378293, 66378297, 4, 640x360 
0x1BF21730, 37561850255833360, 66378323, 66378326, 3, 640x360 
0x1BF21730, 37561850256153104, 66378358, 66378362, 4, 640x360 
0x1BF21730, 37561850256474088, 66378387, 66378390, 3, 640x360 
0x1BF21730, 37561850256793984, 66378417, 66378420, 3, 640x360 
0x1BF21730, 37561850257115904, 66378454, 66378457, 3, 640x360 
0x1BF21730, 37561850257437600, 66378481, 66378485, 4, 640x360 
0x1BF21730, 37561850257757136, 66378515, 66378518, 3, 640x360 
0x1BF21730, 37561850258078392, 66378551, 66378554, 3, 640x360 
0x1BF21730, 37561850258392992, 66378580, 66378585, 5, 640x360 
0x1BF21730, 37561850258873000, 66378626, 66378630, 4, 640x360 
0x1BF21730, 37561850259193536, 66378657, 66378661, 4, 640x360 
0x1BF21730, 37561850259519792, 66378693, 66378698, 5, 640x360 
0x1BF21730, 37561850259833096, 66378722, 66378725, 3, 640x360 
0x1BF21730, 37561850260153384, 66378757, 66378760, 3, 640x360 
0x1BF21730, 37561850260473152, 66378788, 66378793, 5, 640x360 
0x1BF21730, 37561850260794048, 66378822, 66378825, 3, 640x360 
0x1BF21730, 37561850261118064, 66378851, 66378855, 4, 640x360 
0x1BF21730, 37561850261434816, 66378884, 66378888, 4, 640x360 
0x1BF21730, 37561850261757512, 66378913, 66378918, 5, 640x360 
0x1BF21730, 37561850262079560, 66378948, 66378953, 5, 640x360 
0x1BF21730, 37561850262393304, 66378977, 66378986, 9, 640x360 
0x1BF21730, 37561850262712880, 66379011, 66379020, 9, 640x360 
0x1BF21730, 37561850263194024, 66379062, 66379066, 4, 640x360 
0x1BF21730, 37561850263513112, 66379090, 66379094, 4, 640x360 
0x1BF21730, 37561850263833632, 66379125, 66379129, 4, 640x360 
0x1BF21730, 37561850264153240, 66379154, 66379157, 3, 640x360 
0x1BF21730, 37561850264473000, 66379188, 66379191, 3, 640x360 
0x1BF21730, 37561850264793240, 66379217, 66379220, 3, 640x360 
0x1BF21730, 37561850265113856, 66379252, 66379256, 4, 640x360 
0x1BF21730, 37561850265438056, 66379282, 66379286, 4, 640x360 
0x1BF21730, 37561850265761128, 66379316, 66379319, 3, 640x360 
0x1BF21730, 37561850266077944, 66379350, 66379353, 3, 640x360 
0x1BF21730, 37561850266395056, 66379377, 66379382, 5, 640x360 
0x1BF21730, 37561850266713440, 66379411, 66379416, 5, 640x360 
0x1BF21730, 37561850267033512, 66379446, 66379450, 4, 640x360 
0x1BF21730, 37561850267513048, 66379492, 66379496, 4, 640x360 
0x1BF21730, 37561850267832728, 66379522, 66379525, 3, 640x360 
0x1BF21730, 37561850268152984, 66379555, 66379558, 3, 640x360 
0x1BF21730, 37561850268474632, 66379590, 66379593, 3, 640x360 
0x1BF21730, 37561850268794056, 66379620, 66379623, 3, 640x360 
0x1BF21730, 37561850269114776, 66379652, 66379655, 3, 640x360 
0x1BF21730, 37561850269437672, 66379686, 66379689, 3, 640x360 
0x1BF21730, 37561850269757872, 66379715, 66379717, 2, 640x360 
0x1BF21730, 37561850270073904, 66379750, 66379753, 3, 640x360 
0x1BF21730, 37561850270392984, 66379779, 66379785, 6, 640x360 
0x1BF21730, 37561850270713416, 66379809, 66379813, 4, 640x360 
0x1BF21730, 37561850271034280, 66379846, 66379850, 4, 640x360 
0x1BF21730, 37561850271352792, 66379876, 66379882, 6, 640x360 
0x1BF21730, 37561850271833040, 66379923, 66379927, 4, 640x360 
0x1BF21730, 37561850272155576, 66379958, 66379962, 4, 640x360 
0x1BF21730, 37561850272472704, 66379989, 66379992, 3, 640x360 
0x1BF21730, 37561850272793896, 66380019, 66380023, 4, 640x360 
0x1BF21730, 37561850273113680, 66380048, 66380052, 4, 640x360 
0x1BF21730, 37561850273438032, 66380084, 66380087, 3, 640x360 
0x1BF21730, 37561850273755824, 66380114, 66380117, 3, 640x360 
0x1BF21730, 37561850274079624, 66380147, 66380151, 4, 640x360 
0x1BF21730, 37561850274393384, 66380181, 66380185, 4, 640x360 
0x1BF21730, 37561850274715024, 66380212, 66380216, 4, 640x360 
0x1BF21730, 37561850275034496, 66380241, 66380245, 4, 640x360 
0x1BF21730, 37561850275353112, 66380275, 66380279, 4, 640x360 
0x1BF21730, 37561850275672472, 66380309, 66380313, 4, 640x360 
0x1BF21730, 37561850276152768, 66380355, 66380358, 3, 640x360 
0x1BF21730, 37561850276473256, 66380390, 66380394, 4, 640x360 
0x1BF21730, 37561850276794768, 66380419, 66380422, 3, 640x360 
0x1BF21730, 37561850277113328, 66380448, 66380451, 3, 640x360 
0x1BF21730, 37561850277437960, 66380485, 66380488, 3, 640x360 
0x1BF21730, 37561850277757424, 66380515, 66380518, 3, 640x360 
0x1BF21730, 37561850278076040, 66380550, 66380553, 3, 640x360 
0x1BF21730, 37561850278393080, 66380579, 66380585, 6, 640x360 
0x1BF21730, 37561850278712984, 66380614, 66380620, 6, 640x360 
0x1BF21730, 37561850279032944, 66380641, 66380645, 4, 640x360 
0x1BF21730, 37561850279352928, 66380676, 66380679, 3, 640x360 
0x1BF21730, 37561850279672600, 66380704, 66380708, 4, 640x360 
0x1BF21730, 37561850279994704, 66380738, 66380741, 3, 640x360 
0x1BF21730, 37561850280473448, 66380784, 66380787, 3, 640x360 
0x1BF21730, 37561850280794504, 66380820, 66380823, 3, 640x360 
0x1BF21730, 37561850281113240, 66380850, 66380853, 3, 640x360 
0x1BF21730, 37561850281435184, 66380885, 66380888, 3, 640x360 
0x1BF21730, 37561850281755992, 66380915, 66380918, 3, 640x360 
0x1BF21730, 37561850282076696, 66380946, 66380951, 5, 640x360 
0x1BF21730, 37561850282393976, 66380982, 66380986, 4, 640x360 
0x1BF21730, 37561850282713384, 66381010, 66381015, 5, 640x360 
0x1BF21730, 37561850283033152, 66381045, 66381049, 4, 640x360 
0x1BF21730, 37561850283354344, 66381075, 66381079, 4, 640x360 
0x1BF21730, 37561850283675224, 66381110, 66381114, 4, 640x360 
0x1BF21730, 37561850283993456, 66381139, 66381143, 4, 640x360 
0x1BF21730, 37561850284313232, 66381173, 66381177, 4, 640x360 
0x1BF21730, 37561850284793080, 66381220, 66381222, 2, 640x360 
0x1BF21730, 37561850285113456, 66381254, 66381258, 4, 640x360 
0x1BF21730, 37561850285436408, 66381283, 66381286, 3, 640x360 
0x1BF21730, 37561850285757440, 66381318, 66381321, 3, 640x360 
0x1BF21730, 37561850286075848, 66381346, 66381350, 4, 640x360 
0x1BF21730, 37561850286393984, 66381381, 66381390, 9, 640x360 
0x1BF21730, 37561850286713560, 66381410, 66381414, 4, 640x360 
0x1BF21730, 37561850287032944, 66381445, 66381449, 4, 640x360 
0x1BF21730, 37561850287356752, 66381474, 66381477, 3, 640x360 
0x1BF21730, 37561850287673696, 66381510, 66381516, 6, 640x360 
0x1BF21730, 37561850287994424, 66381539, 66381541, 2, 640x360 
0x1BF21730, 37561850288317552, 66381573, 66381576, 3, 640x360 
0x1BF21730, 37561850288636200, 66381603, 66381606, 3, 640x360 
0x1BF21730, 37561850289114624, 66381649, 66381652, 3, 640x360 
0x1BF21730, 37561850289436840, 66381685, 66381688, 3, 640x360 
0x1BF21730, 37561850289756408, 66381714, 66381720, 6, 640x360 
0x1BF21730, 37561850290077648, 66381748, 66381754, 6, 640x360 
0x1BF21730, 37561850290394976, 66381779, 66381785, 6, 640x360 
0x1BF21730, 37561850290713096, 66381810, 66381815, 5, 640x360 
0x1BF21730, 37561850291033936, 66381846, 66381852, 6, 640x360 
0x1BF21730, 37561850291353328, 66381874, 66381878, 4, 640x360 
0x1BF21730, 37561850291672616, 66381909, 66381913, 4, 640x360 
0x1BF21730, 37561850291993592, 66381938, 66381941, 3, 640x360 
0x1BF21730, 37561850292313024, 66381974, 66381977, 3, 640x360 
0x1BF21730, 37561850292633128, 66382004, 66382007, 3, 640x360 
0x1BF21730, 37561850293433856, 66382086, 66382089, 3, 640x360 
0x1BF21730, 37561850293757032, 66382116, 66382119, 3, 640x360 
0x1BF21730, 37561850294080120, 66382146, 66382150, 4, 640x360 
0x1BF21730, 37561850294394112, 66382181, 66382185, 4, 640x360 
0x1BF21730, 37561850294713744, 66382209, 66382213, 4, 640x360 
0x1BF21730, 37561850295033896, 66382245, 66382248, 3, 640x360 
0x1BF21730, 37561850295352736, 66382273, 66382276, 3, 640x360 
0x1BF21730, 37561850295672728, 66382308, 66382312, 4, 640x360 
0x1BF21730, 37561850295993216, 66382338, 66382341, 3, 640x360 
0x1BF21730, 37561850296312872, 66382372, 66382375, 3, 640x360 
0x1BF21730, 37561850296633256, 66382402, 66382405, 3, 640x360 
0x1BF21730, 37561850296953344, 66382437, 66382440, 3, 640x360 
0x1BF21730, 37561850297274296, 66382468, 66382472, 4, 640x360 
0x1BF21730, 37561850297753008, 66382515, 66382518, 3, 640x360 
0x1BF21730, 37561850298075304, 66382550, 66382553, 3, 640x360 
0x1BF21730, 37561850298393072, 66382579, 66382585, 6, 640x360 
0x1BF21730, 37561850298712944, 66382614, 66382620, 6, 640x360 
0x1BF21730, 37561850299033120, 66382642, 66382646, 4, 640x360 
0x1BF21730, 37561850299352904, 66382676, 66382680, 4, 640x360 
0x1BF21730, 37561850299672840, 66382705, 66382708, 3, 640x360 
0x1BF21730, 37561850299993712, 66382741, 66382746, 5, 640x360 
0x1BF21730, 37561850300313400, 66382769, 66382772, 3, 640x360 
0x1BF21730, 37561850300633584, 66382805, 66382808, 3, 640x360 
0x1BF21730, 37561850300953424, 66382835, 66382838, 3, 640x360 
0x1BF21730, 37561850301272688, 66382870, 66382873, 3, 640x360 
0x1BF21730, 37561850301752984, 66382916, 66382919, 3, 640x360 
0x1BF21730, 37561850302073416, 66382945, 66382951, 6, 640x360 
0x1BF21730, 37561850302394344, 66382980, 66382986, 6, 640x360 
0x1BF21730, 37561850302713512, 66383009, 66383013, 4, 640x360 
0x1BF21730, 37561850303033672, 66383045, 66383049, 4, 640x360 
0x1BF21730, 37561850303353384, 66383075, 66383078, 3, 640x360 
0x1BF21730, 37561850303672672, 66383109, 66383113, 4, 640x360 
0x1BF21730, 37561850303993040, 66383139, 66383142, 3, 640x360 
0x1BF21730, 37561850304313264, 66383172, 66383175, 3, 640x360 
0x1BF21730, 37561850304632936, 66383203, 66383207, 4, 640x360 
0x1BF21730, 37561850304954232, 66383237, 66383240, 3, 640x360 
0x1BF21730, 37561850305272824, 66383266, 66383269, 3, 640x360 
0x1BF21730, 37561850305597664, 66383300, 66383303, 3, 640x360 
0x1BF21730, 37561850306073480, 66383346, 66383350, 4, 640x360 
0x1BF21730, 37561850306392904, 66383381, 66383385, 4, 640x360 
0x1BF21730, 37561850306712792, 66383409, 66383413, 4, 640x360 
0x1BF21730, 37561850307033104, 66383446, 66383452, 6, 640x360 
0x1BF21730, 37561850307352984, 66383476, 66383480, 4, 640x360 
0x1BF21730, 37561850307673024, 66383505, 66383508, 3, 640x360 
0x1BF21730, 37561850307993240, 66383539, 66383542, 3, 640x360 
0x1BF21730, 37561850308313528, 66383573, 66383576, 3, 640x360 
0x1BF21730, 37561850308633816, 66383602, 66383605, 3, 640x360 
0x1BF21730, 37561850308953336, 66383635, 66383638, 3, 640x360 
0x1BF21730, 37561850309274528, 66383668, 66383671, 3, 640x360 
0x1BF21730, 37561850309597432, 66383701, 66383704, 3, 640x360 
0x1BF21730, 37561850309913616, 66383729, 66383732, 3, 640x360 
0x1BF21730, 37561850310392856, 66383782, 66383786, 4, 640x360 
0x1BF21730, 37561850310713144, 66383833, 66383838, 5, 320x180 
0x1BF21730, 37561850312312960, 66383972, 66383975, 3, 320x180 
0x1BF21730, 37561850313594760, 66384102, 66384105, 3, 320x180 
0x1BF21730, 37561850314713528, 66384214, 66384216, 2, 320x180 
0x1BF21730, 37561850316313344, 66384372, 66384374, 2, 320x180 
0x1BF21730, 37561850317597704, 66384502, 66384507, 5, 320x180 
0x1BF21730, 37561850319034008, 66384642, 66384645, 3, 320x180 
0x1BF21730, 37561850320312936, 66384772, 66384774, 2, 320x180 
0x1BF21730, 37561850321597104, 66384900, 66384903, 3, 320x180 
0x1BF21730, 37561850322873160, 66385029, 66385033, 4, 320x180 
0x1BF21730, 37561850324313136, 66385175, 66385178, 3, 320x180 
0x1BF21730, 37561850325597760, 66385301, 66385304, 3, 320x180 
0x1BF21730, 37561850326872528, 66385427, 66385430, 3, 320x180 
0x1BF21730, 37561850328313144, 66385572, 66385576, 4, 320x180 
0x1BF21730, 37561850329598712, 66385699, 66385702, 3, 320x180 
0x1BF21730, 37561850330873576, 66385829, 66385832, 3, 320x180 
0x1BF21730, 37561850332315512, 66385974, 66385977, 3, 320x180 
0x1BF21730, 37561850333596072, 66386101, 66386104, 3, 320x180 
0x1BF21730, 37561850334872768, 66386227, 66386230, 3, 320x180 
0x1BF21730, 37561850336313096, 66386372, 66386374, 2, 320x180 
0x1BF21730, 37561850337598640, 66386502, 66386504, 2, 320x180 
0x1BF21730, 37561850338873592, 66386625, 66386628, 3, 320x180 
0x1BF21730, 37561850340152560, 66386756, 66386758, 2, 320x180 
0x1BF21730, 37561850341598064, 66386899, 66386901, 2, 320x180 
0x1BF21730, 37561850342873480, 66387026, 66387029, 3, 320x180 
0x1BF21730, 37561850344153168, 66387154, 66387156, 2, 320x180 
0x1BF21730, 37561850345598136, 66387298, 66387300, 2, 320x180 
0x1BF21730, 37561850346873504, 66387427, 66387435, 8, 320x180 
0x1BF21730, 37561850348152880, 66387553, 66387555, 2, 320x180 
0x1BF21730, 37561850349595272, 66387698, 66387700, 2, 320x180 
0x1BF21730, 37561850350873184, 66387829, 66387833, 4, 320x180 
0x1BF21730, 37561850352152904, 66387955, 66387957, 2, 320x180 
0x1BF21730, 37561850353593360, 66388102, 66388104, 2, 320x180 
0x1BF21730, 37561850354872984, 66388230, 66388233, 3, 320x180 
0x1BF21730, 37561850356153240, 66388353, 66388355, 2, 320x180 
0x1BF21730, 37561850357439376, 66388486, 66388489, 3, 320x180 
0x1BF21730, 37561850358873208, 66388625, 66388628, 3, 320x180 
0x1BF21730, 37561850360152984, 66388753, 66388755, 2, 320x180 
0x1BF21730, 37561850361437560, 66388883, 66388885, 2, 320x180 
0x1BF21730, 37561850362873688, 66389025, 66389030, 5, 320x180 
0x1BF21730, 37561850364153072, 66389153, 66389156, 3, 320x180 
0x1BF21730, 37561850365436400, 66389284, 66389287, 3, 320x180 
0x1BF21730, 37561850366872992, 66389428, 66389434, 6, 320x180 
0x1BF21730, 37561850368153304, 66389557, 66389560, 3, 320x180 
0x1BF21730, 37561850369436912, 66389685, 66389687, 2, 320x180 
0x1BF21730, 37561850370872880, 66389829, 66389834, 5, 320x180 
0x1BF21730, 37561850372153336, 66389958, 66389961, 3, 320x180 
0x1BF21730, 37561850373438056, 66390086, 66390088, 2, 320x180 
0x1BF21730, 37561850374713320, 66390213, 66390218, 5, 320x180 
0x1BF21730, 37561850376153288, 66390357, 66390360, 3, 320x180 
0x1BF21730, 37561850377438000, 66390487, 66390489, 2, 320x180 
0x1BF21730, 37561850378715240, 66390611, 66390616, 5, 320x180 
0x1BF21730, 37561850380152960, 66390753, 66390755, 2, 320x180 
0x1BF21730, 37561850381437880, 66390882, 66390884, 2, 320x180 
0x1BF21730, 37561850383032720, 66391042, 66391044, 2, 320x180 
0x1BF21730, 37561850384153424, 66391158, 66391161, 3, 320x180 
0x1BF21730, 37561850385435984, 66391284, 66391286, 2, 320x180 
0x1BF21730, 37561850387033144, 66391443, 66391446, 3, 320x180 
0x1BF21730, 37561850388153072, 66391554, 66391557, 3, 320x180 
0x1BF21730, 37561850389437400, 66391682, 66391684, 2, 320x180 
0x1BF21730, 37561850390713696, 66391809, 66391812, 3, 320x180 
0x1BF21730, 37561850392472848, 66391990, 66391992, 2, 320x180 
0x1BF21730, 37561850393436568, 66392086, 66392088, 2, 320x180 
0x1BF21730, 37561850394713344, 66392212, 66392217, 5, 320x180 
0x1BF21730, 37561850396313384, 66392372, 66392373, 1, 320x180 
0x1BF21730, 37561850397434136, 66392481, 66392484, 3, 320x180 
0x1BF21730, 37561850398713232, 66392613, 66392618, 5, 320x180 
0x1BF21730, 37561850400313416, 66392773, 66392776, 3, 320x180 
0x1BF21730, 37561850401434056, 66392885, 66392887, 2, 320x180 
0x1BF21730, 37561850402713376, 66393008, 66393015, 7, 320x180 
0x1BF21730, 37561850404313240, 66393173, 66393175, 2, 320x180 
0x1BF21730, 37561850405433464, 66393281, 66393284, 3, 320x180 
0x1BF21730, 37561850406713440, 66393410, 66393413, 3, 320x180 
0x1BF21730, 37561850408312752, 66393571, 66393573, 2, 320x180 
0x1BF21730, 37561850409753096, 66393716, 66393718, 2, 320x180 
0x1BF21730, 37561850410713832, 66393811, 66393816, 5, 320x180 
0x1BF21730, 37561850412312888, 66393970, 66393972, 2, 320x180 
0x1BF21730, 37561850413597688, 66394102, 66394104, 2, 320x180 
0x1BF21730, 37561850415033088, 66394244, 66394247, 3, 320x180 
0x1BF21730, 37561850416312952, 66394371, 66394373, 2, 320x180 
0x1BF21730, 37561850417597256, 66394499, 66394501, 2, 320x180 
0x1BF21730, 37561850419033104, 66394646, 66394649, 3, 320x180 
0x1BF21730, 37561850420313016, 66394768, 66394770, 2, 320x180 
0x1BF21730, 37561850421597688, 66394900, 66394903, 3, 320x180 
0x1BF21730, 37561850423033072, 66395046, 66395051, 5, 320x180 
0x1BF21730, 37561850424313056, 66395169, 66395171, 2, 320x180 
0x1BF21730, 37561850425598952, 66395299, 66395302, 3, 320x180 
0x1BF21730, 37561850427032832, 66395444, 66395452, 8, 320x180 
0x1BF21730, 37561850428313584, 66395568, 66395570, 2, 320x180 
0x1BF21730, 37561850429596648, 66395698, 66395700, 2, 320x180 
0x1BF21730, 37561850430873368, 66395829, 66395835, 6, 320x180 
0x1BF21730, 37561850432315232, 66395971, 66395973, 2, 320x180 
0x1BF21730, 37561850433597896, 66396098, 66396100, 2, 320x180 
0x1BF21730, 37561850434873152, 66396226, 66396229, 3, 320x180 
0x1BF21730, 37561850436314048, 66396371, 66396373, 2, 320x180 
0x1BF21730, 37561850437596848, 66396503, 66396505, 2, 320x180 
0x1BF21730, 37561850438872960, 66396626, 66396631, 5, 320x180 
0x1BF21730, 37561850440313016, 66396772, 66396774, 2, 320x180 
0x1BF21730, 37561850441596960, 66396898, 66396900, 2, 320x180 
0x1BF21730, 37561850442872824, 66397027, 66397030, 3, 320x180 
0x1BF21730, 37561850444312888, 66397171, 66397173, 2, 320x180 
0x1BF21730, 37561850445598496, 66397302, 66397304, 2, 320x180 
0x1BF21730, 37561850446872816, 66397428, 66397431, 3, 320x180 
0x1BF21730, 37561850448313056, 66397572, 66397574, 2, 320x180 
0x1BF21730, 37561850449596456, 66397698, 66397701, 3, 320x180 
0x1BF21730, 37561850450873456, 66397825, 66397828, 3, 320x180 
0x1BF21730, 37561850452152864, 66397955, 66397957, 2, 320x180 
0x1BF21730, 37561850453596952, 66398101, 66398103, 2, 320x180 
0x1BF21730, 37561850454873032, 66398230, 66398234, 4, 320x180 
0x1BF21730, 37561850456152616, 66398357, 66398359, 2, 320x180 
0x1BF21730, 37561850457595712, 66398502, 66398504, 2, 320x180 
0x1BF21730, 37561850458872968, 66398626, 66398629, 3, 320x180 
0x1BF21730, 37561850460152504, 66398753, 66398755, 2, 320x180 
0x1BF21730, 37561850461595736, 66398898, 66398900, 2, 320x180 
0x1BF21730, 37561850462873040, 66399027, 66399030, 3, 320x180 
0x1BF21730, 37561850464153272, 66399155, 66399157, 2, 320x180 
0x1BF21730, 37561850465593600, 66399298, 66399300, 2, 320x180 
0x1BF21730, 37561850466873536, 66399427, 66399430, 3, 320x180 
0x1BF21730, 37561850468153056, 66399555, 66399557, 2, 320x180 
0x1BF21730, 37561850469436848, 66399686, 66399688, 2, 320x180 
0x1BF21730, 37561850470873328, 66399829, 66399834, 5, 320x180 
0x1BF21730, 37561850472153128, 66399957, 66399959, 2, 320x180 
0x1BF21730, 37561850473434512, 66400084, 66400086, 2, 320x180 
0x1BF21730, 37561850474872632, 66400224, 66400227, 3, 320x180 
0x1BF21730, 37561850476152640, 66400352, 66400355, 3, 320x180 
0x1BF21730, 37561850477433656, 66400483, 66400485, 2, 320x180 
0x1BF21730, 37561850478872968, 66400626, 66400629, 3, 320x180 
0x1BF21730, 37561850480153056, 66400754, 66400756, 2, 320x180 
0x1BF21730, 37561850481433152, 66400881, 66400884, 3, 320x180 
0x1BF21730, 37561850482872472, 66401030, 66401034, 4, 320x180 
0x1BF21730, 37561850484152896, 66401158, 66401161, 3, 320x180 
0x1BF21730, 37561850485434424, 66401282, 66401284, 2, 320x180 
0x1BF21730, 37561850487192840, 66401460, 66401463, 3, 320x180 
0x1BF21730, 37561850488152608, 66401552, 66401555, 3, 320x180 
0x1BF21730, 37561850489436904, 66401685, 66401688, 3, 320x180 
0x1BF21730, 37561850491034048, 66401846, 66401851, 5, 320x180 
0x1BF21730, 37561850492152480, 66401954, 66401956, 2, 320x180 
0x1BF21730, 37561850493433712, 66402081, 66402083, 2, 320x180 
0x1BF21730, 37561850494713288, 66402213, 66402216, 3, 320x180 
0x1BF21730, 37561850496152784, 66402358, 66402361, 3, 320x180 
0x1BF21730, 37561850497434544, 66402485, 66402487, 2, 320x180 
0x1BF21730, 37561850499033704, 66402646, 66402648, 2, 320x180 
0x1BF21730, 37561850500152856, 66402754, 66402756, 2, 320x180 
0x1BF21730, 37561850501433168, 66402885, 66402887, 2, 320x180 
0x1BF21730, 37561850502713216, 66403013, 66403018, 5, 320x180 
0x1BF21730, 37561850504473600, 66403190, 66403192, 2, 320x180 
0x1BF21730, 37561850505438112, 66403283, 66403285, 2, 320x180 
0x1BF21730, 37561850507034696, 66403442, 66403445, 3, 320x180 
0x1BF21730, 37561850508312680, 66403570, 66403572, 2, 320x180 
0x1BF21730, 37561850509433096, 66403682, 66403684, 2, 320x180 
0x1BF21730, 37561850510713112, 66403814, 66403818, 4, 320x180 
0x1BF21730, 37561850512313176, 66403971, 66403973, 2, 320x180 
0x1BF21730, 37561850513433312, 66404086, 66404088, 2, 320x180 
0x1BF21730, 37561850515033256, 66404242, 66404245, 3, 320x180 
0x1BF21730, 37561850516313248, 66404373, 66404375, 2, 320x180 
0x1BF21730, 37561850517433784, 66404485, 66404487, 2, 320x180 
0x1BF21730, 37561850519033064, 66404645, 66404647, 2, 320x180 
0x1BF21730, 37561850520313128, 66404771, 66404772, 1, 320x180 
0x1BF21730, 37561850521752904, 66404916, 66404918, 2, 320x180 
0x1BF21730, 37561850522713104, 66405010, 66405015, 5, 320x180 
0x1BF21730, 37561850524313448, 66405173, 66405175, 2, 320x180 
0x1BF21730, 37561850525596888, 66405298, 66405300, 2, 320x180 
0x1BF21730, 37561850527032928, 66405443, 66405446, 3, 320x180 
0x1BF21730, 37561850528313504, 66405570, 66405572, 2, 320x180 
0x1BF21730, 37561850529594200, 66405697, 66405699, 2, 320x180 
0x1BF21730, 37561850531033000, 66405841, 66405844, 3, 320x180 
0x1BF21730, 37561850532313616, 66405972, 66405974, 2, 320x180 
0x1BF21730, 37561850533594904, 66406097, 66406099, 2, 320x180 
0x1BF21730, 37561850534713600, 66406212, 66406214, 2, 320x180 
0x1BF21730, 37561850536312800, 66406371, 66406373, 2, 320x180 
0x1BF21730, 37561850537594952, 66406499, 66406501, 2, 320x180 
0x1BF21730, 37561850539033336, 66406645, 66406650, 5, 320x180 
0x1BF21730, 37561850540313024, 66406772, 66406774, 2, 320x180 
0x1BF21730, 37561850541596504, 66406899, 66406901, 2, 320x180 
0x1BF21730, 37561850542872688, 66407025, 66407028, 3, 320x180 
0x1BF21730, 37561850544313192, 66407170, 66407172, 2, 320x180 
0x1BF21730, 37561850545595024, 66407302, 66407304, 2, 320x180 
0x1BF21730, 37561850546873008, 66407429, 66407432, 3, 320x180 
0x1BF21730, 37561850548313288, 66407570, 66407572, 2, 320x180 
0x1BF21730, 37561850549597496, 66407701, 66407704, 3, 320x180 
0x1BF21730, 37561850550872440, 66407828, 66407831, 3, 320x180 
0x1BF21730, 37561850552313496, 66407973, 66407975, 2, 320x180 
0x1BF21730, 37561850553598120, 66408100, 66408103, 3, 320x180 
0x1BF21730, 37561850554872152, 66408225, 66408229, 4, 320x180 
0x1BF21730, 37561850556313040, 66408372, 66408374, 2, 320x180 
0x1BF21730, 37561850557596344, 66408498, 66408501, 3, 320x180 
0x1BF21730, 37561850558872320, 66408625, 66408628, 3, 320x180 
0x1BF21730, 37561850560152704, 66408756, 66408759, 3, 320x180 
0x1BF21730, 37561850561594840, 66408899, 66408901, 2, 320x180 
0x1BF21730, 37561850562873320, 66409029, 66409034, 5, 320x180 
0x1BF21730, 37561850564153200, 66409154, 66409156, 2, 320x180 
0x1BF21730, 37561850565593544, 66409297, 66409299, 2, 320x180 
0x1BF21730, 37561850566873040, 66409425, 66409434, 9, 320x180 
0x1BF21730, 37561850568152920, 66409553, 66409555, 2, 320x180 
0x1BF21730, 37561850569595152, 66409701, 66409703, 2, 320x180 
0x1BF21730, 37561850570872648, 66409830, 66409832, 2, 320x180 
0x1BF21730, 37561850572153224, 66409954, 66409956, 2, 320x180 
0x1BF21730, 37561850573594064, 66410099, 66410102, 3, 320x180 
0x1BF21730, 37561850574872896, 66410227, 66410233, 6, 320x180 
0x1BF21730, 37561850576152712, 66410353, 66410355, 2, 320x180 
0x1BF21730, 37561850577433312, 66410482, 66410485, 3, 320x180 
0x1BF21730, 37561850578872600, 66410626, 66410629, 3, 320x180 
0x1BF21730, 37561850580153120, 66410754, 66410756, 2, 320x180 
0x1BF21730, 37561850581433448, 66410883, 66410885, 2, 320x180 
0x1BF21730, 37561850582872856, 66411025, 66411033, 8, 320x180 
0x1BF21730, 37561850584153096, 66411157, 66411160, 3, 320x180 
0x1BF21730, 37561850585435704, 66411284, 66411286, 2, 320x180 
0x1BF21730, 37561850586873176, 66411425, 66411432, 7, 320x180 
0x1BF21730, 37561850588152824, 66411552, 66411555, 3, 320x180 
0x1BF21730, 37561850589433072, 66411685, 66411687, 2, 320x180 
0x1BF21730, 37561850590872848, 66411825, 66411828, 3, 320x180 
0x1BF21730, 37561850592153376, 66411954, 66411956, 2, 320x180 
0x1BF21730, 37561850593435568, 66412083, 66412085, 2, 320x180 
0x1BF21730, 37561850594873688, 66412229, 66412232, 3, 320x180 
0x1BF21730, 37561850596152928, 66412355, 66412358, 3, 320x180 
0x1BF21730, 37561850597433520, 66412480, 66412482, 2, 320x180 
0x1BF21730, 37561850598713920, 66412611, 66412615, 4, 320x180 
0x1BF21730, 37561850600152656, 66412755, 66412757, 2, 320x180 
0x1BF21730, 37561850601433488, 66412884, 66412886, 2, 320x180 
0x1BF21730, 37561850602713656, 66413013, 66413016, 3, 320x180 
0x1BF21730, 37561850604152792, 66413155, 66413157, 2, 320x180 
0x1BF21730, 37561850605435040, 66413283, 66413285, 2, 320x180 
0x1BF21730, 37561850606713656, 66413413, 66413415, 2, 320x180 
0x1BF21730, 37561850608152912, 66413556, 66413558, 2, 320x180 
0x1BF21730, 37561850609433864, 66413685, 66413687, 2, 320x180 
0x1BF21730, 37561850610713304, 66413812, 66413815, 3, 320x180 
0x1BF21730, 37561850612152752, 66413955, 66413957, 2, 320x180 
0x1BF21730, 37561850613433144, 66414084, 66414086, 2, 320x180 
0x1BF21730, 37561850614713912, 66414211, 66414215, 4, 320x180 
0x1BF21730, 37561850616473264, 66414389, 66414391, 2, 320x180 
0x1BF21730, 37561850617433184, 66414482, 66414485, 3, 320x180 
0x1BF21730, 37561850618714120, 66414614, 66414617, 3, 320x180 
0x1BF21730, 37561850620312744, 66414772, 66414774, 2, 320x180 
0x1BF21730, 37561850621433424, 66414882, 66414884, 2, 320x180 
0x1BF21730, 37561850622713856, 66415012, 66415014, 2, 320x180 
0x1BF21730, 37561850624312864, 66415170, 66415172, 2, 320x180 
0x1BF21730, 37561850625433552, 66415281, 66415283, 2, 320x180 
0x1BF21730, 37561850626714392, 66415413, 66415415, 2, 320x180 
0x1BF21730, 37561850628312688, 66415573, 66415576, 3, 320x180 
0x1BF21730, 37561850629433424, 66415683, 66415685, 2, 320x180 
0x1BF21730, 37561850630713872, 66415810, 66415816, 6, 320x180 
0x1BF21730, 37561850632313000, 66415972, 66415974, 2, 320x180 
0x1BF21730, 37561850633752792, 66416117, 66416119, 2, 320x180 
0x1BF21730, 37561850634713480, 66416213, 66416216, 3, 320x180 
0x1BF21730, 37561850636312992, 66416372, 66416374, 2, 320x180 
0x1BF21730, 37561850637593656, 66416499, 66416502, 3, 320x180 
0x1BF21730, 37561850638713504, 66416611, 66416615, 4, 320x180 
0x1BF21730, 37561850640313696, 66416773, 66416775, 2, 320x180 
0x1BF21730, 37561850641593312, 66416897, 66416899, 2, 320x180 
0x1BF21730, 37561850642714360, 66417010, 66417016, 6, 320x180 
0x1BF21730, 37561850644313232, 66417172, 66417174, 2, 320x180 
0x1BF21730, 37561850645593072, 66417298, 66417300, 2, 320x180 
0x1BF21730, 37561850646714584, 66417410, 66417413, 3, 320x180 
0x1BF21730, 37561850648313000, 66417571, 66417573, 2, 320x180 
0x1BF21730, 37561850649592768, 66417699, 66417701, 2, 320x180 
0x1BF21730, 37561850651033520, 66417844, 66417847, 3, 320x180 
0x1BF21730, 37561850652313976, 66417971, 66417973, 2, 320x180 
0x1BF21730, 37561850653838040, 66418122, 66418125, 3, 320x180 
0x1BF21730, 37561850654872768, 66418227, 66418230, 3, 320x180 
0x1BF21730, 37561850656313144, 66418371, 66418373, 2, 320x180 
0x1BF21730, 37561850657593736, 66418499, 66418501, 2, 320x180 
0x1BF21730, 37561850658872856, 66418625, 66418632, 7, 320x180 
0x1BF21730, 37561850660312840, 66418772, 66418775, 3, 320x180 
0x1BF21730, 37561850661593824, 66418900, 66418902, 2, 320x180 
0x1BF21730, 37561850662872728, 66419030, 66419033, 3, 320x180 
0x1BF21730, 37561850664314176, 66419174, 66419177, 3, 320x180 
0x1BF21730, 37561850665593344, 66419301, 66419304, 3, 320x180 
0x1BF21730, 37561850666872568, 66419427, 66419431, 4, 320x180 
0x1BF21730, 37561850668312888, 66419572, 66419574, 2, 320x180 
0x1BF21730, 37561850669593872, 66419700, 66419702, 2, 320x180 
0x1BF21730, 37561850670872648, 66419827, 66419832, 5, 320x180 
0x1BF21730, 37561850672152424, 66419956, 66419959, 3, 320x180 
0x1BF21730, 37561850673593384, 66420098, 66420101, 3, 320x180 
0x1BF21730, 37561850674873216, 66420227, 66420232, 5, 320x180 
0x1BF21730, 37561850676152768, 66420356, 66420358, 2, 320x180 
0x1BF21730, 37561850677594040, 66420500, 66420502, 2, 320x180 
0x1BF21730, 37561850678872520, 66420626, 66420631, 5, 320x180 
0x1BF21730, 37561850680152400, 66420753, 66420755, 2, 320x180 
0x1BF21730, 37561850681593696, 66420897, 66420899, 2, 320x180 
0x1BF21730, 37561850682872976, 66421025, 66421032, 7, 320x180 
0x1BF21730, 37561850684152488, 66421154, 66421156, 2, 320x180 
0x1BF21730, 37561850685593616, 66421302, 66421304, 2, 320x180 
0x1BF21730, 37561850686873008, 66421427, 66421432, 5, 320x180 
0x1BF21730, 37561850688153016, 66421558, 66421564, 6, 320x180 
0x1BF21730, 37561850689433776, 66421683, 66421685, 2, 320x180 
0x1BF21730, 37561850690872512, 66421827, 66421831, 4, 320x180 
0x1BF21730, 37561850692153032, 66421955, 66421957, 2, 320x180 
0x1BF21730, 37561850693433272, 66422084, 66422086, 2, 320x180 
0x1BF21730, 37561850694873080, 66422229, 66422232, 3, 320x180 
0x1BF21730, 37561850696152904, 66422352, 66422356, 4, 320x180 
0x1BF21730, 37561850697433680, 66422485, 66422488, 3, 320x180 
0x1BF21730, 37561850698872384, 66422628, 66422632, 4, 320x180 
0x1BF21730, 37561850700152888, 66422756, 66422759, 3, 320x180 
0x1BF21730, 37561850701433096, 66422885, 66422887, 2, 320x180 
0x1BF21730, 37561850702872816, 66423028, 66423033, 5, 320x180 
0x1BF21730, 37561850704152736, 66423153, 66423155, 2, 320x180 
0x1BF21730, 37561850705433040, 66423284, 66423286, 2, 320x180 
0x1BF21730, 37561850706713424, 66423412, 66423416, 4, 320x180 
0x1BF21730, 37561850708152832, 66423557, 66423560, 3, 320x180 
0x1BF21730, 37561850709432824, 66423683, 66423686, 3, 320x180 
0x1BF21730, 37561850710872888, 66423828, 66423831, 3, 320x180 
0x1BF21730, 37561850712153008, 66423957, 66423960, 3, 320x180 
0x1BF21730, 37561850713593648, 66424099, 66424101, 2, 320x180 
0x1BF21730, 37561850714872912, 66424228, 66424231, 3, 320x180 
0x1BF21730, 37561850716153216, 66424354, 66424356, 2, 320x180 
0x1BF21730, 37561850717434352, 66424486, 66424488, 2, 320x180 
0x1BF21730, 37561850718872936, 66424628, 66424632, 4, 320x180 
0x1BF21730, 37561850720153160, 66424756, 66424759, 3, 320x180 
0x1BF21730, 37561850721432984, 66424884, 66424886, 2, 320x180 
0x1BF21730, 37561850722874608, 66425028, 66425032, 4, 320x180 
0x1BF21730, 37561850724153912, 66425153, 66425159, 6, 320x180 
0x1BF21730, 37561850725432856, 66425281, 66425283, 2, 320x180 
0x1BF21730, 37561850726876768, 66425430, 66425433, 3, 320x180 
0x1BF21730, 37561850728153248, 66425556, 66425564, 8, 320x180 
0x1BF21730, 37561850729433392, 66425684, 66425686, 2, 320x180 
0x1BF21730, 37561850730874112, 66425826, 66425837, 11, 320x180 
0x1BF21730, 37561850732152864, 66425956, 66425958, 2, 320x180 
0x1BF21730, 37561850733433376, 66426086, 66426089, 3, 320x180 
0x1BF21730, 37561850734713048, 66426214, 66426216, 2, 320x180 
0x1BF21730, 37561850736153616, 66426355, 66426358, 3, 320x180 
0x1BF21730, 37561850737439744, 66426484, 66426486, 2, 320x180 
0x1BF21730, 37561850738715744, 66426613, 66426619, 6, 320x180 
0x1BF21730, 37561850740153328, 66426756, 66426759, 3, 320x180 
0x1BF21730, 37561850741433304, 66426882, 66426884, 2, 320x180 
0x1BF21730, 37561850742713784, 66427013, 66427015, 2, 320x180 
0x1BF21730, 37561850744153344, 66427154, 66427156, 2, 320x180 
0x1BF21730, 37561850745435904, 66427281, 66427285, 4, 320x180 
0x1BF21730, 37561850746713440, 66427413, 66427415, 2, 320x180 
0x1BF21730, 37561850748152920, 66427557, 66427560, 3, 320x180 
0x1BF21730, 37561850749436056, 66427687, 66427689, 2, 320x180 
0x1BF21730, 37561850750713112, 66427814, 66427818, 4, 320x180 
0x1BF21730, 37561850752472896, 66427987, 66427989, 2, 320x180 
0x1BF21730, 37561850753434840, 66428081, 66428083, 2, 320x180 
0x1BF21730, 37561850754714752, 66428213, 66428216, 3, 320x180 
0x1BF21730, 37561850756315752, 66428372, 66428374, 2, 320x180 
0x1BF21730, 37561850757433352, 66428485, 66428487, 2, 320x180 
0x1BF21730, 37561850758713040, 66428610, 66428613, 3, 320x180 
0x1BF21730, 37561850760313016, 66428772, 66428774, 2, 320x180 
0x1BF21730, 37561850761434008, 66428887, 66428889, 2, 320x180 
0x1BF21730, 37561850762713288, 66429014, 66429020, 6, 320x180 
0x1BF21730, 37561850764312952, 66429170, 66429172, 2, 320x180 
0x1BF21730, 37561850765433776, 66429281, 66429283, 2, 320x180 
0x1BF21730, 37561850766713608, 66429411, 66429414, 3, 320x180 
0x1BF21730, 37561850768312624, 66429571, 66429573, 2, 320x180 
0x1BF21730, 37561850769752872, 66429712, 66429714, 2, 320x180 
0x1BF21730, 37561850770714840, 66429812, 66429816, 4, 320x180 
0x1BF21730, 37561850772312336, 66429972, 66429974, 2, 320x180 
0x1BF21730, 37561850773594312, 66430101, 66430104, 3, 320x180 
0x1BF21730, 37561850774719392, 66430210, 66430213, 3, 320x180 
0x1BF21730, 37561850776314672, 66430373, 66430376, 3, 320x180 
0x1BF21730, 37561850777593552, 66430497, 66430499, 2, 320x180 
0x1BF21730, 37561850778715320, 66430611, 66430613, 2, 320x180 
0x1BF21730, 37561850780313056, 66430770, 66430772, 2, 320x180 
0x1BF21730, 37561850781594328, 66430901, 66430903, 2, 320x180 
0x1BF21730, 37561850782715600, 66431011, 66431014, 3, 320x180 
0x1BF21730, 37561850784312808, 66431170, 66431172, 2, 320x180 
0x1BF21730, 37561850785594376, 66431298, 66431300, 2, 320x180 
0x1BF21730, 37561850786714832, 66431411, 66431417, 6, 320x180 
0x1BF21730, 37561850788312952, 66431573, 66431578, 5, 320x180 
0x1BF21730, 37561850789593696, 66431698, 66431701, 3, 320x180 
0x1BF21730, 37561850791032760, 66431843, 66431845, 2, 320x180 
0x1BF21730, 37561850792313840, 66431970, 66431972, 2, 320x180 
0x1BF21730, 37561850793595920, 66432098, 66432101, 3, 320x180 
0x1BF21730, 37561850794874352, 66432232, 66432237, 5, 320x180 
0x1BF21730, 37561850796313968, 66432372, 66432374, 2, 320x180 
0x1BF21730, 37561850797597648, 66432502, 66432505, 3, 320x180 
0x1BF21730, 37561850798872608, 66432625, 66432631, 6, 320x180 
0x1BF21730, 37561850800312920, 66432769, 66432771, 2, 320x180 
0x1BF21730, 37561850801594288, 66432897, 66432899, 2, 320x180 
0x1BF21730, 37561850802872432, 66433028, 66433030, 2, 320x180 
0x1BF21730, 37561850804312792, 66433169, 66433171, 2, 320x180 
0x1BF21730, 37561850805593976, 66433297, 66433299, 2, 320x180 
0x1BF21730, 37561850806872376, 66433425, 66433431, 6, 320x180 
0x1BF21730, 37561850808313400, 66433572, 66433574, 2, 320x180 
0x1BF21730, 37561850809594152, 66433698, 66433700, 2, 320x180 
0x1BF21730, 37561850810872608, 66433826, 66433835, 9, 320x180 
0x1BF21730, 37561850812154416, 66433954, 66433956, 2, 320x180 
0x1BF21730, 37561850813596104, 66434103, 66434105, 2, 320x180 
0x1BF21730, 37561850814872608, 66434227, 66434233, 6, 320x180 
0x1BF21730, 37561850816152400, 66434356, 66434365, 9, 320x180 
0x1BF21730, 37561850817595648, 66434498, 66434502, 4, 320x180 
0x1BF21730, 37561850818873016, 66434629, 66434638, 9, 320x180 
0x1BF21730, 37561850820152584, 66434754, 66434756, 2, 320x180 
0x1BF21730, 37561850821600416, 66434900, 66434902, 2, 320x180 
0x1BF21730, 37561850822872384, 66435028, 66435031, 3, 320x180 
0x1BF21730, 37561850824152560, 66435154, 66435156, 2, 320x180 
0x1BF21730, 37561850825592800, 66435301, 66435303, 2, 320x180 
0x1BF21730, 37561850826872648, 66435428, 66435431, 3, 320x180 
0x1BF21730, 37561850828152992, 66435557, 66435560, 3, 320x180 
0x1BF21730, 37561850829433984, 66435686, 66435688, 2, 320x180 
0x1BF21730, 37561850830873592, 66435827, 66435831, 4, 320x180 
0x1BF21730, 37561850832153040, 66435953, 66435955, 2, 320x180 
0x1BF21730, 37561850833433432, 66436084, 66436086, 2, 320x180 
0x1BF21730, 37561850834873192, 66436229, 66436232, 3, 320x180 
0x1BF21730, 37561850836152944, 66436358, 66436361, 3, 320x180 
0x1BF21730, 37561850837434024, 66436481, 66436485, 4, 320x180 
0x1BF21730, 37561850838872808, 66436630, 66436632, 2, 320x180 
0x1BF21730, 37561850840153072, 66436756, 66436759, 3, 320x180 
0x1BF21730, 37561850841432920, 66436881, 66436883, 2, 320x180 
0x1BF21730, 37561850842873296, 66437029, 66437032, 3, 320x180 
0x1BF21730, 37561850844152872, 66437158, 66437161, 3, 320x180 
0x1BF21730, 37561850845433176, 66437282, 66437284, 2, 320x180 
0x1BF21730, 37561850846718056, 66437412, 66437414, 2, 320x180 
0x1BF21730, 37561850848152824, 66437553, 66437555, 2, 320x180 
0x1BF21730, 37561850849433216, 66437681, 66437685, 4, 320x180 
0x1BF21730, 37561850850717864, 66437813, 66437820, 7, 320x180 
0x1BF21730, 37561850852152808, 66437955, 66437958, 3, 320x180 
0x1BF21730, 37561850853434368, 66438083, 66438085, 2, 320x180 
0x1BF21730, 37561850854717400, 66438215, 66438217, 2, 320x180 
0x1BF21730, 37561850856152200, 66438353, 66438355, 2, 320x180 
0x1BF21730, 37561850857434632, 66438487, 66438489, 2, 320x180 
0x1BF21730, 37561850858717848, 66438611, 66438614, 3, 320x180 
0x1BF21730, 37561850860152712, 66438753, 66438755, 2, 320x180 
0x1BF21730, 37561850861433712, 66438884, 66438886, 2, 320x180 
0x1BF21730, 37561850862718616, 66439011, 66439015, 4, 320x180 
0x1BF21730, 37561850864473416, 66439189, 66439192, 3, 320x180 
0x1BF21730, 37561850865433056, 66439285, 66439287, 2, 320x180 
0x1BF21730, 37561850866718080, 66439414, 66439417, 3, 320x180 
0x1BF21730, 37561850868312912, 66439570, 66439572, 2, 320x180 
0x1BF21730, 37561850869433432, 66439681, 66439684, 3, 320x180 
0x1BF21730, 37561850870716440, 66439814, 66439817, 3, 320x180 
0x1BF21730, 37561850872314120, 66439973, 66439976, 3, 320x180 
0x1BF21730, 37561850873433216, 66440082, 66440084, 2, 320x180 
0x1BF21730, 37561850874717816, 66440212, 66440215, 3, 320x180 
0x1BF21730, 37561850876312648, 66440373, 66440376, 3, 320x180 
0x1BF21730, 37561850877433088, 66440482, 66440484, 2, 320x180 
0x1BF21730, 37561850878716248, 66440610, 66440613, 3, 320x180 
0x1BF21730, 37561850880312472, 66440772, 66440774, 2, 320x180 
0x1BF21730, 37561850881752792, 66440913, 66440915, 2, 320x180 
0x1BF21730, 37561850882719184, 66441012, 66441016, 4, 320x180 
0x1BF21730, 37561850884312752, 66441169, 66441170, 1, 320x180 
0x1BF21730, 37561850885594752, 66441300, 66441302, 2, 320x180 
0x1BF21730, 37561850886715824, 66441410, 66441413, 3, 320x180 
0x1BF21730, 37561850888313392, 66441570, 66441574, 4, 320x180 
0x1BF21730, 37561850889595400, 66441699, 66441701, 2, 320x180 
0x1BF21730, 37561850890719144, 66441810, 66441814, 4, 320x180 
0x1BF21730, 37561850892313984, 66441970, 66441972, 2, 320x180 
0x1BF21730, 37561850893597384, 66442098, 66442101, 3, 320x180 
0x1BF21730, 37561850894713400, 66442212, 66442214, 2, 320x180 
0x1BF21730, 37561850896313264, 66442373, 66442386, 13, 320x180 
0x1BF21730, 37561850897599608, 66442499, 66442502, 3, 320x180 
0x1BF21730, 37561850899033032, 66442646, 66442652, 6, 320x180 
0x1BF21730, 37561850900313232, 66442772, 66442774, 2, 320x180 
0x1BF21730, 37561850901592608, 66442899, 66442901, 2, 320x180 
0x1BF21730, 37561850902874128, 66443027, 66443031, 4, 320x180 
0x1BF21730, 37561850904312992, 66443170, 66443172, 2, 320x180 
0x1BF21730, 37561850905593400, 66443298, 66443300, 2, 320x180 
0x1BF21730, 37561850906874952, 66443430, 66443432, 2, 320x180 
0x1BF21730, 37561850908313120, 66443574, 66443577, 3, 320x180 
0x1BF21730, 37561850909593232, 66443701, 66443704, 3, 320x180 
0x1BF21730, 37561850910876256, 66443827, 66443830, 3, 320x180 
0x1BF21730, 37561850912312736, 66443969, 66443971, 2, 320x180 
0x1BF21730, 37561850913594960, 66444101, 66444103, 2, 320x180 
0x1BF21730, 37561850914873816, 66444229, 66444231, 2, 320x180 
0x1BF21730, 37561850916312736, 66444370, 66444372, 2, 320x180 
0x1BF21730, 37561850917593256, 66444500, 66444502, 2, 320x180 
0x1BF21730, 37561850918876936, 66444630, 66444633, 3, 320x180 
0x1BF21730, 37561850920153448, 66444754, 66444756, 2, 320x180 
0x1BF21730, 37561850921593256, 66444898, 66444900, 2, 320x180 
0x1BF21730, 37561850922876376, 66445029, 66445032, 3, 320x180 
0x1BF21730, 37561850924152832, 66445156, 66445159, 3, 320x180 
0x1BF21730, 37561850925593584, 66445299, 66445301, 2, 320x180 
0x1BF21730, 37561850926876008, 66445426, 66445429, 3, 320x180 
0x1BF21730, 37561850928152512, 66445553, 66445555, 2, 320x180 
0x1BF21730, 37561850929593152, 66445698, 66445700, 2, 320x180 
0x1BF21730, 37561850930873952, 66445828, 66445830, 2, 320x180 
0x1BF21730, 37561850932152248, 66445953, 66445955, 2, 320x180 
0x1BF21730, 37561850933594224, 66446102, 66446105, 3, 320x180 
0x1BF21730, 37561850934874056, 66446227, 66446230, 3, 320x180 
0x1BF21730, 37561850936152656, 66446356, 66446359, 3, 320x180 
0x1BF21730, 37561850937593288, 66446497, 66446499, 2, 320x180 
0x1BF21730, 37561850938876880, 66446632, 66446634, 2, 320x180 
0x1BF21730, 37561850940153408, 66446756, 66446759, 3, 320x180 
0x1BF21730, 37561850941432960, 66446881, 66446883, 2, 320x180 
0x1BF21730, 37561850942874024, 66447029, 66447031, 2, 320x180 
0x1BF21730, 37561850944152952, 66447156, 66447159, 3, 320x180 
0x1BF21730, 37561850945432968, 66447280, 66447283, 3, 320x180 
0x1BF21730, 37561850946875456, 66447426, 66447429, 3, 320x180 
0x1BF21730, 37561850948152416, 66447556, 66447558, 2, 320x180 
0x1BF21730, 37561850949432432, 66447681, 66447684, 3, 320x180 
0x1BF21730, 37561850950878464, 66447826, 66447829, 3, 320x180 
0x1BF21730, 37561850952153256, 66447958, 66447961, 3, 320x180 
0x1BF21730, 37561850953433448, 66448085, 66448087, 2, 320x180 
0x1BF21730, 37561850954873216, 66448225, 66448227, 2, 320x180 
0x1BF21730, 37561850956153232, 66448354, 66448356, 2, 320x180 
0x1BF21730, 37561850957433096, 66448482, 66448484, 2, 320x180 
0x1BF21730, 37561850958717208, 66448611, 66448612, 1, 320x180 
0x1BF21730, 37561850960152312, 66448755, 66448757, 2, 320x180 
0x1BF21730, 37561850961433264, 66448880, 66448882, 2, 320x180 
0x1BF21730, 37561850962717808, 66449015, 66449017, 2, 320x180 
0x1BF21730, 37561850964152752, 66449153, 66449155, 2, 320x180 
0x1BF21730, 37561850965432896, 66449281, 66449284, 3, 320x180 
0x1BF21730, 37561850966717840, 66449410, 66449413, 3, 320x180 
0x1BF21730, 37561850968152464, 66449556, 66449558, 2, 320x180 
0x1BF21730, 37561850969433200, 66449686, 66449688, 2, 320x180 
0x1BF21730, 37561850970716888, 66449815, 66449817, 2, 320x180 
0x1BF21730, 37561850972153048, 66449953, 66449955, 2, 320x180 
0x1BF21730, 37561850973433280, 66450084, 66450086, 2, 320x180 
0x1BF21730, 37561850974718040, 66450215, 66450217, 2, 320x180 
0x1BF21730, 37561850976472536, 66450388, 66450391, 3, 320x180 
0x1BF21730, 37561850977432832, 66450483, 66450485, 2, 320x180 
0x1BF21730, 37561850978718216, 66450613, 66450616, 3, 320x180 
0x1BF21730, 37561850980312632, 66450772, 66450774, 2, 320x180 
0x1BF21730, 37561850981432768, 66450881, 66450884, 3, 320x180 
0x1BF21730, 37561850982717528, 66451013, 66451015, 2, 320x180 
0x1BF21730, 37561850984312856, 66451173, 66451176, 3, 320x180 
0x1BF21730, 37561850985433232, 66451282, 66451285, 3, 320x180 
0x1BF21730, 37561850986716792, 66451414, 66451416, 2, 320x180 
0x1BF21730, 37561850988312976, 66451570, 66451572, 2, 320x180 
0x1BF21730, 37561850989434448, 66451685, 66451688, 3, 320x180 
0x1BF21730, 37561850990716856, 66451815, 66451817, 2, 320x180 
0x1BF21730, 37561850992312600, 66451969, 66451971, 2, 320x180 
0x1BF21730, 37561850993753336, 66452117, 66452119, 2, 320x180 
0x1BF21730, 37561850994717584, 66452211, 66452213, 2, 320x180 
0x1BF21730, 37561850996314472, 66452373, 66452376, 3, 320x180 
0x1BF21730, 37561850997593080, 66452498, 66452500, 2, 320x180 
0x1BF21730, 37561850998715176, 66452611, 66452613, 2, 320x180 
0x1BF21730, 37561851000313384, 66452770, 66452772, 2, 320x180 
0x1BF21730, 37561851001594008, 66452902, 66452904, 2, 320x180 
0x1BF21730, 37561851002719032, 66453013, 66453015, 2, 320x180 
0x1BF21730, 37561851004313200, 66453172, 66453175, 3, 320x180 
0x1BF21730, 37561851005592816, 66453300, 66453302, 2, 320x180 
0x1BF21730, 37561851006713168, 66453409, 66453412, 3, 320x180 
0x1BF21730, 37561851008313576, 66453570, 66453572, 2, 320x180 
0x1BF21730, 37561851009593760, 66453702, 66453704, 2, 320x180 
0x1BF21730, 37561851011033672, 66453842, 66453844, 2, 320x180 
0x1BF21730, 37561851012312752, 66453971, 66453973, 2, 320x180 
0x1BF21730, 37561851013593984, 66454099, 66454102, 3, 320x180 
0x1BF21730, 37561851014877504, 66454226, 66454229, 3, 320x180 
0x1BF21730, 37561851016312984, 66454371, 66454373, 2, 320x180 
0x1BF21730, 37561851017592824, 66454502, 66454505, 3, 320x180 
0x1BF21730, 37561851018877576, 66454630, 66454632, 2, 320x180 
0x1BF21730, 37561851020312688, 66454774, 66454777, 3, 320x180 
0x1BF21730, 37561851021592920, 66454899, 66454901, 2, 320x180 
0x1BF21730, 37561851022876944, 66455028, 66455030, 2, 320x180 
0x1BF21730, 37561851024313456, 66455173, 66455176, 3, 320x180 
0x1BF21730, 37561851025593560, 66455302, 66455304, 2, 320x180 
0x1BF21730, 37561851026876160, 66455428, 66455431, 3, 320x180 
0x1BF21730, 37561851028313112, 66455573, 66455576, 3, 320x180 
0x1BF21730, 37561851029592776, 66455698, 66455700, 2, 320x180 
0x1BF21730, 37561851030877608, 66455827, 66455829, 2, 320x180 
0x1BF21730, 37561851032152680, 66455956, 66455958, 2, 320x180 
0x1BF21730, 37561851033594032, 66456099, 66456101, 2, 320x180 
0x1BF21730, 37561851034876072, 66456231, 66456233, 2, 320x180 
0x1BF21730, 37561851036152296, 66456356, 66456358, 2, 320x180 
0x1BF21730, 37561851037592920, 66456497, 66456499, 2, 320x180 
0x1BF21730, 37561851038877424, 66456630, 66456633, 3, 320x180 
0x1BF21730, 37561851040152616, 66456757, 66456759, 2, 320x180 
0x1BF21730, 37561851041592808, 66456900, 66456902, 2, 320x180 
0x1BF21730, 37561851042876144, 66457031, 66457033, 2, 320x180 
0x1BF21730, 37561851044152336, 66457153, 66457155, 2, 320x180 
0x1BF21730, 37561851045592664, 66457301, 66457304, 3, 320x180 
0x1BF21730, 37561851046876328, 66457428, 66457430, 2, 320x180 
0x1BF21730, 37561851048152472, 66457558, 66457561, 3, 320x180 
0x1BF21730, 37561851049434480, 66457684, 66457686, 2, 320x180 
0x1BF21730, 37561851050876040, 66457828, 66457830, 2, 320x180 
0x1BF21730, 37561851052152480, 66457954, 66457956, 2, 320x180 
0x1BF21730, 37561851053432800, 66458082, 66458084, 2, 320x180 
0x1BF21730, 37561851054876160, 66458226, 66458229, 3, 320x180 
0x1BF21730, 37561851056152968, 66458353, 66458355, 2, 320x180 
0x1BF21730, 37561851057432680, 66458483, 66458486, 3, 320x180 
0x1BF21730, 37561851058874912, 66458628, 66458631, 3, 320x180 
0x1BF21730, 37561851060152344, 66458753, 66458755, 2, 320x180 
0x1BF21730, 37561851061432824, 66458883, 66458885, 2, 320x180 
0x1BF21730, 37561851062874016, 66459029, 66459031, 2, 320x180 
0x1BF21730, 37561851064153000, 66459153, 66459155, 2, 320x180 
0x1BF21730, 37561851065432696, 66459285, 66459287, 2, 320x180 
0x1BF21730, 37561851066717704, 66459411, 66459413, 2, 320x180 
0x1BF21730, 37561851068152928, 66459557, 66459563, 6, 320x180 
0x1BF21730, 37561851069433128, 66459683, 66459685, 2, 320x180 
0x1BF21730, 37561851070716352, 66459810, 66459812, 2, 320x180 
0x1BF21730, 37561851072153072, 66459956, 66459959, 3, 320x180 
0x1BF21730, 37561851073432832, 66460108, 66460111, 3, 320x180 
0x1BF21730, 37561851074718496, 66460214, 66460216, 2, 320x180 
0x1BF21730, 37561851076152328, 66460353, 66460355, 2, 320x180 
0x1BF21730, 37561851077433200, 66460483, 66460486, 3, 320x180 
0x1BF21730, 37561851078715768, 66460613, 66460616, 3, 320x180 
0x1BF21730, 37561851080152472, 66460754, 66460757, 3, 320x180 
0x1BF21730, 37561851081432896, 66460880, 66460882, 2, 320x180 
0x1BF21730, 37561851082715744, 66461015, 66461017, 2, 320x180 
0x1BF21730, 37561851084152728, 66461154, 66461157, 3, 320x180 
0x1BF21730, 37561851085433216, 66461284, 66461286, 2, 320x180 
0x1BF21730, 37561851086716256, 66461409, 66461411, 2, 320x180 
0x1BF21730, 37561851088472328, 66461589, 66461592, 3, 320x180 
0x1BF21730, 37561851089435464, 66461684, 66461686, 2, 320x180 
0x1BF21730, 37561851090718152, 66461810, 66461813, 3, 320x180 
0x1BF21730, 37561851092313024, 66461972, 66461975, 3, 320x180 
0x1BF21730, 37561851093432752, 66462082, 66462084, 2, 320x180 
0x1BF21730, 37561851094717520, 66462211, 66462213, 2, 320x180 
0x1BF21730, 37561851096312816, 66462371, 66462373, 2, 320x180 
0x1BF21730, 37561851097432664, 66462483, 66462485, 2, 320x180 
0x1BF21730, 37561851098715768, 66462609, 66462612, 3, 320x180 
0x1BF21730, 37561851100312712, 66462770, 66462772, 2, 320x180 
0x1BF21730, 37561851101432624, 66462883, 66462885, 2, 320x180 
0x1BF21730, 37561851102715648, 66463012, 66463014, 2, 320x180 
0x1BF21730, 37561851104312768, 66463172, 66463175, 3, 320x180 
0x1BF21730, 37561851105753136, 66463318, 66463320, 2, 320x180 
0x1BF21730, 37561851106715744, 66463412, 66463414, 2, 320x180 
0x1BF21730, 37561851108312896, 66463572, 66463575, 3, 320x180 
0x1BF21730, 37561851109592728, 66463698, 66463700, 2, 320x180 
0x1BF21730, 37561851110715232, 66463811, 66463814, 3, 320x180 
0x1BF21730, 37561851112313728, 66463974, 66463977, 3, 320x180 
0x1BF21730, 37561851113594848, 66464098, 66464100, 2, 320x180 
0x1BF21730, 37561851114716776, 66464213, 66464215, 2, 320x180 
0x1BF21730, 37561851116313352, 66464369, 66464371, 2, 320x180 
0x1BF21730, 37561851117593216, 66464497, 66464499, 2, 320x180 
0x1BF21730, 37561851119035424, 66464645, 66464647, 2, 320x180 
0x1BF21730, 37561851120313384, 66464770, 66464772, 2, 320x180 
0x1BF21730, 37561851121592480, 66464900, 66464902, 2, 320x180 
0x1BF21730, 37561851123032576, 66465045, 66465047, 2, 320x180 
0x1BF21730, 37561851124312904, 66465169, 66465171, 2, 320x180 
0x1BF21730, 37561851125593288, 66465297, 66465299, 2, 320x180 
0x1BF21730, 37561851126876896, 66465431, 66465433, 2, 320x180 
0x1BF21730, 37561851128313848, 66465571, 66465574, 3, 320x180 
0x1BF21730, 37561851129594000, 66465698, 66465700, 2, 320x180 
0x1BF21730, 37561851130877520, 66465827, 66465829, 2, 320x180 
0x1BF21730, 37561851132312952, 66465970, 66465972, 2, 320x180 
0x1BF21730, 37561851133594808, 66466099, 66466102, 3, 320x180 
0x1BF21730, 37561851134876528, 66466230, 66466233, 3, 320x180 
0x1BF21730, 37561851136312856, 66466373, 66466376, 3, 320x180 
0x1BF21730, 37561851137593200, 66466498, 66466500, 2, 320x180 
0x1BF21730, 37561851138877096, 66466625, 66466628, 3, 320x180 
0x1BF21730, 37561851140312608, 66466774, 66466777, 3, 320x180 
0x1BF21730, 37561851141592808, 66466901, 66466903, 2, 320x180 
0x1BF21730, 37561851142878576, 66467030, 66467032, 2, 320x180 
0x1BF21730, 37561851144152832, 66467157, 66467160, 3, 320x180 
0x1BF21730, 37561851145592888, 66467297, 66467299, 2, 320x180 
0x1BF21730, 37561851146876160, 66467427, 66467429, 2, 320x180 
0x1BF21730, 37561851148153920, 66467554, 66467556, 2, 320x180 
0x1BF21730, 37561851149593048, 66467702, 66467704, 2, 320x180 
0x1BF21730, 37561851150876944, 66467827, 66467831, 4, 320x180 
0x1BF21730, 37561851152152592, 66467953, 66467955, 2, 320x180 
0x1BF21730, 37561851153593632, 66468100, 66468102, 2, 320x180 
0x1BF21730, 37561851154876944, 66468229, 66468231, 2, 320x180 
0x1BF21730, 37561851156153096, 66468356, 66468361, 5, 320x180 
0x1BF21730, 37561851157592640, 66468499, 66468501, 2, 320x180 
0x1BF21730, 37561851158876744, 66468627, 66468630, 3, 320x180 
0x1BF21730, 37561851160152976, 66468755, 66468757, 2, 320x180 
0x1BF21730, 37561851161433152, 66468881, 66468883, 2, 320x180 
0x1BF21730, 37561851162875392, 66469030, 66469032, 2, 320x180 
0x1BF21730, 37561851164153208, 66469153, 66469155, 2, 320x180 
0x1BF21730, 37561851165433800, 66469283, 66469285, 2, 320x180 
0x1BF21730, 37561851166875864, 66469425, 66469428, 3, 320x180 
0x1BF21730, 37561851168153240, 66469557, 66469560, 3, 320x180 
0x1BF21730, 37561851169436456, 66469682, 66469685, 3, 320x180 
0x1BF21730, 37561851170876008, 66469826, 66469829, 3, 320x180 
0x1BF21730, 37561851172152416, 66469952, 66469955, 3, 320x180 
0x1BF21730, 37561851173434208, 66470087, 66470089, 2, 320x180 
0x1BF21730, 37561851174873184, 66470229, 66470231, 2, 320x180 
0x1BF21730, 37561851176152728, 66470356, 66470359, 3, 320x180 
0x1BF21730, 37561851177433272, 66470483, 66470485, 2, 320x180 
0x1BF21730, 37561851178716664, 66470611, 66470613, 2, 320x180 
0x1BF21730, 37561851180152824, 66470758, 66470761, 3, 320x180 
0x1BF21730, 37561851181432840, 66470883, 66470885, 2, 320x180 
0x1BF21730, 37561851182715728, 66471015, 66471018, 3, 320x180 
0x1BF21730, 37561851184152248, 66471156, 66471168, 12, 320x180 
0x1BF21730, 37561851185437656, 66471284, 66471286, 2, 320x180 
0x1BF21730, 37561851186717504, 66471413, 66471415, 2, 320x180 
0x1BF21730, 37561851188153976, 66471553, 66471555, 2, 320x180 
0x1BF21730, 37561851189433600, 66471687, 66471695, 8, 320x180 
0x1BF21730, 37561851190717080, 66471810, 66471819, 9, 320x180 
0x1BF21730, 37561851192152176, 66471953, 66471956, 3, 320x180 
0x1BF21730, 37561851193432976, 66472083, 66472086, 3, 320x180 
0x1BF21730, 37561851194714744, 66472210, 66472217, 7, 320x180 
0x1BF21730, 37561851196473984, 66472389, 66472401, 12, 320x180 
0x1BF21730, 37561851197437008, 66472486, 66472488, 2, 320x180 
0x1BF21730, 37561851198716384, 66472615, 66472618, 3, 320x180 
0x1BF21730, 37561851200314152, 66472772, 66472775, 3, 320x180 
0x1BF21730, 37561851201433176, 66472881, 66472884, 3, 320x180 
0x1BF21730, 37561851202715680, 66473010, 66473015, 5, 320x180 
0x1BF21730, 37561851204313008, 66473174, 66473177, 3, 320x180 
0x1BF21730, 37561851205432568, 66473283, 66473286, 3, 320x180 
0x1BF21730, 37561851206714240, 66473410, 66473413, 3, 320x180 
0x1BF21730, 37561851208312512, 66473572, 66473574, 2, 320x180 
0x1BF21730, 37561851209432936, 66473684, 66473686, 2, 320x180 
0x1BF21730, 37561851211033112, 66473846, 66473849, 3, 320x180 
0x1BF21730, 37561851212313688, 66473971, 66473973, 2, 320x180 
0x1BF21730, 37561851213753464, 66474113, 66474119, 6, 320x180 
0x1BF21730, 37561851214715320, 66474210, 66474213, 3, 320x180 
0x1BF21730, 37561851216312128, 66474372, 66474384, 12, 320x180 
0x1BF21730, 37561851217593992, 66474502, 66474505, 3, 320x180 
0x1BF21730, 37561851218715824, 66474615, 66474617, 2, 320x180 
0x1BF21730, 37561851220312512, 66474771, 66474779, 8, 320x180 
0x1BF21730, 37561851221601496, 66474898, 66474900, 2, 320x180 
0x1BF21730, 37561851222719784, 66475013, 66475017, 4, 320x180 
0x1BF21730, 37561851224312568, 66475171, 66475173, 2, 320x180 
0x1BF21730, 37561851225599368, 66475301, 66475303, 2, 320x180 
0x1BF21730, 37561851226720904, 66475416, 66475418, 2, 320x180 
0x1BF21730, 37561851228313656, 66475571, 66475583, 12, 320x180 
0x1BF21730, 37561851229598912, 66475699, 66475701, 2, 320x180 
0x1BF21730, 37561851230713432, 66475813, 66475818, 5, 320x180 
0x1BF21730, 37561851232313072, 66475972, 66475974, 2, 320x180 
0x1BF21730, 37561851233593056, 66476099, 66476101, 2, 320x180 
0x1BF21730, 37561851235032944, 66476241, 66476243, 2, 320x180 
0x1BF21730, 37561851236313168, 66476371, 66476374, 3, 320x180 
0x1BF21730, 37561851237593680, 66476497, 66476499, 2, 320x180 
0x1BF21730, 37561851238875856, 66476631, 66476633, 2, 320x180 
0x1BF21730, 37561851240313016, 66476771, 66476774, 3, 320x180 
0x1BF21730, 37561851241592888, 66476901, 66476904, 3, 320x180 
0x1BF21730, 37561851242875696, 66477025, 66477030, 5, 320x180 
0x1BF21730, 37561851244313088, 66477171, 66477184, 13, 320x180 
0x1BF21730, 37561851245597648, 66477302, 66477304, 2, 320x180 
0x1BF21730, 37561851246875456, 66477428, 66477434, 6, 320x180 
0x1BF21730, 37561851248312880, 66477573, 66477582, 9, 320x180 
0x1BF21730, 37561851249807272, 66477720, 66477727, 7, 320x180 
0x1BF21730, 37561851250875064, 66477827, 66477834, 7, 320x180 
0x1BF21730, 37561851252313688, 66477973, 66477976, 3, 320x180 
0x1BF21730, 37561851253593560, 66478102, 66478104, 2, 320x180 
0x1BF21730, 37561851254876624, 66478228, 66478234, 6, 320x180 
0x1BF21730, 37561851256151944, 66478354, 66478367, 13, 320x180 
0x1BF21730, 37561851257598912, 66478502, 66478504, 2, 320x180 
0x1BF21730, 37561851258878144, 66478631, 66478634, 3, 320x180 
0x1BF21730, 37561851260152896, 66478753, 66478755, 2, 320x180 
0x1BF21730, 37561851261593240, 66478899, 66478901, 2, 320x180 
0x1BF21730, 37561851262878128, 66479031, 66479033, 2, 320x180 
0x1BF21730, 37561851264153344, 66479158, 66479161, 3, 320x180 
0x1BF21730, 37561851265592696, 66479297, 66479299, 2, 320x180 
0x1BF21730, 37561851266876816, 66479429, 66479431, 2, 320x180 
0x1BF21730, 37561851268153048, 66479556, 66479564, 8, 320x180 
0x1BF21730, 37561851269593888, 66479701, 66479704, 3, 320x180 
0x1BF21730, 37561851270873352, 66479828, 66479832, 4, 320x180 
0x1BF21730, 37561851272153472, 66479958, 66479961, 3, 320x180 
0x1BF21730, 37561851273432712, 66480083, 66480085, 2, 320x180 
0x1BF21730, 37561851274874576, 66480229, 66480231, 2, 320x180 
0x1BF21730, 37561851276153480, 66480353, 66480355, 2, 320x180 
0x1BF21730, 37561851277432808, 66480482, 66480484, 2, 320x180 
0x1BF21730, 37561851278875432, 66480629, 66480631, 2, 320x180 
0x1BF21730, 37561851280153448, 66480753, 66480756, 3, 320x180 
0x1BF21730, 37561851281432368, 66480881, 66480883, 2, 320x180 
0x1BF21730, 37561851282874376, 66481028, 66481030, 2, 320x180 
0x1BF21730, 37561851284152920, 66481157, 66481160, 3, 320x180 
0x1BF21730, 37561851285432208, 66481283, 66481285, 2, 320x180 
0x1BF21730, 37561851286872720, 66481428, 66481430, 2, 320x180 
0x1BF21730, 37561851288152712, 66481557, 66481560, 3, 320x180 
0x1BF21730, 37561851289435968, 66481683, 66481685, 2, 320x180 
0x1BF21730, 37561851290717640, 66481810, 66481817, 7, 320x180 
0x1BF21730, 37561851292152336, 66481954, 66481967, 13, 320x180 
0x1BF21730, 37561851293436632, 66482085, 66482087, 2, 320x180 
0x1BF21730, 37561851294719408, 66482212, 66482216, 4, 320x180 
0x1BF21730, 37561851296152328, 66482356, 66482360, 4, 320x180 
0x1BF21730, 37561851297432736, 66482485, 66482487, 2, 320x180 
0x1BF21730, 37561851298715808, 66482611, 66482613, 2, 320x180 
0x1BF21730, 37561851300152032, 66482752, 66482755, 3, 320x180 
0x1BF21730, 37561851301434896, 66482886, 66482888, 2, 320x180 
0x1BF21730, 37561851302717088, 66483012, 66483015, 3, 320x180 
0x1BF21730, 37561851304152912, 66483158, 66483160, 2, 320x180 
0x1BF21730, 37561851305433824, 66483281, 66483284, 3, 320x180 
0x1BF21730, 37561851306716632, 66483412, 66483415, 3, 320x180 
0x1BF21730, 37561851308472176, 66483585, 66483588, 3, 320x180 
0x1BF21730, 37561851309437624, 66483686, 66483689, 3, 320x180 
0x1BF21730, 37561851310717208, 66483814, 66483817, 3, 320x180 
0x1BF21730, 37561851312313056, 66483969, 66483978, 9, 320x180 
0x1BF21730, 37561851313436520, 66484086, 66484088, 2, 320x180 
0x1BF21730, 37561851314716552, 66484212, 66484217, 5, 320x180 
0x1BF21730, 37561851316312648, 66484370, 66484373, 3, 320x180 
0x1BF21730, 37561851317434432, 66484481, 66484484, 3, 320x180 
0x1BF21730, 37561851318714864, 66484613, 66484615, 2, 320x180 
0x1BF21730, 37561851320317448, 66484770, 66484778, 8, 320x180 
0x1BF21730, 37561851321432840, 66484883, 66484885, 2, 320x180 
0x1BF21730, 37561851322715680, 66485012, 66485018, 6, 320x180 
0x1BF21730, 37561851324507816, 66485192, 66485201, 9, 320x180 
0x1BF21730, 37561851325754192, 66485319, 66485322, 3, 320x180 
0x1BF21730, 37561851326718304, 66485415, 66485417, 2, 320x180 
0x1BF21730, 37561851328313544, 66485574, 66485584, 10, 320x180 
0x1BF21730, 37561851329596024, 66485701, 66485703, 2, 320x180 
0x1BF21730, 37561851330715280, 66485810, 66485812, 2, 320x180 
0x1BF21730, 37561851332312864, 66485969, 66485971, 2, 320x180 
0x1BF21730, 37561851333593144, 66486100, 66486102, 2, 320x180 
0x1BF21730, 37561851334717816, 66486213, 66486215, 2, 320x180 
0x1BF21730, 37561851336313616, 66486369, 66486371, 2, 320x180 
0x1BF21730, 37561851337592528, 66486501, 66486503, 2, 320x180 
0x1BF21730, 37561851339037848, 66486642, 66486644, 2, 320x180 
0x1BF21730, 37561851340313152, 66486773, 66486776, 3, 320x180 
0x1BF21730, 37561851341592432, 66486898, 66486900, 2, 320x180 
0x1BF21730, 37561851343033464, 66487044, 66487046, 2, 320x180 
0x1BF21730, 37561851344312488, 66487172, 66487175, 3, 320x180 
0x1BF21730, 37561851345592352, 66487300, 66487302, 2, 320x180 
0x1BF21730, 37561851346876288, 66487429, 66487431, 2, 320x180 
0x1BF21730, 37561851348312376, 66487569, 66487571, 2, 320x180 
0x1BF21730, 37561851349593264, 66487702, 66487704, 2, 320x180 
0x1BF21730, 37561851350876488, 66487829, 66487831, 2, 320x180 
0x1BF21730, 37561851352312736, 66487973, 66487976, 3, 320x180 
0x1BF21730, 37561851353595016, 66488102, 66488104, 2, 320x180 
0x1BF21730, 37561851354877048, 66488229, 66488231, 2, 320x180 
0x1BF21730, 37561851356312328, 66488372, 66488374, 2, 320x180 
0x1BF21730, 37561851357592640, 66488501, 66488503, 2, 320x180 
0x1BF21730, 37561851358875920, 66488626, 66488628, 2, 320x180 
0x1BF21730, 37561851360312264, 66488771, 66488773, 2, 320x180 
0x1BF21730, 37561851361593072, 66488898, 66488900, 2, 320x180 
0x1BF21730, 37561851362874888, 66489026, 66489028, 2, 320x180 
0x1BF21730, 37561851364152976, 66489153, 66489156, 3, 320x180 
0x1BF21730, 37561851365599056, 66489301, 66489303, 2, 320x180 
0x1BF21730, 37561851366875944, 66489431, 66489433, 2, 320x180 
0x1BF21730, 37561851368153760, 66489558, 66489561, 3, 320x180 
0x1BF21730, 37561851369594664, 66489701, 66489703, 2, 320x180 
0x1BF21730, 37561851370876456, 66489827, 66489835, 8, 320x180 
0x1BF21730, 37561851372152080, 66489953, 66489962, 9, 320x180 
0x1BF21730, 37561851373597352, 66490099, 66490102, 3, 320x180 
0x1BF21730, 37561851374876696, 66490227, 66490234, 7, 320x180 
0x1BF21730, 37561851376152960, 66490356, 66490359, 3, 320x180 
0x1BF21730, 37561851377593016, 66490500, 66490502, 2, 320x180 
0x1BF21730, 37561851378875344, 66490629, 66490631, 2, 320x180 
0x1BF21730, 37561851380152632, 66490758, 66490764, 6, 320x180 
0x1BF21730, 37561851381592544, 66490898, 66490900, 2, 320x180 
0x1BF21730, 37561851382874920, 66491030, 66491032, 2, 320x180 
0x1BF21730, 37561851384152680, 66491157, 66491160, 3, 320x180 
0x1BF21730, 37561851385432528, 66491283, 66491286, 3, 320x180 
0x1BF21730, 37561851386875720, 66491431, 66491433, 2, 320x180 
0x1BF21730, 37561851388152320, 66491556, 66491564, 8, 320x180 
0x1BF21730, 37561851389435512, 66491681, 66491684, 3, 320x180 
0x1BF21730, 37561851390874064, 66491826, 66491828, 2, 320x180 
0x1BF21730, 37561851392153432, 66491953, 66491956, 3, 320x180 
0x1BF21730, 37561851393432608, 66492080, 66492082, 2, 320x180 
0x1BF21730, 37561851394875208, 66492226, 66492228, 2, 320x180 
0x1BF21730, 37561851396152848, 66492354, 66492357, 3, 320x180 
0x1BF21730, 37561851397432928, 66492483, 66492486, 3, 320x180 
0x1BF21730, 37561851398872144, 66492626, 66492628, 2, 320x180 
0x1BF21730, 37561851400152712, 66492754, 66492757, 3, 320x180 
0x1BF21730, 37561851401432616, 66492881, 66492883, 2, 320x180 
0x1BF21730, 37561851402717464, 66493014, 66493016, 2, 320x180 
0x1BF21730, 37561851404152272, 66493157, 66493160, 3, 320x180 
0x1BF21730, 37561851405433160, 66493283, 66493285, 2, 320x180 
0x1BF21730, 37561851406716256, 66493412, 66493414, 2, 320x180 
0x1BF21730, 37561851408152640, 66493554, 66493557, 3, 320x180 
0x1BF21730, 37561851409434032, 66493682, 66493684, 2, 320x180 
0x1BF21730, 37561851410718040, 66493813, 66493815, 2, 320x180 
0x1BF21730, 37561851412152328, 66493955, 66493965, 10, 320x180 
0x1BF21730, 37561851413432632, 66494083, 66494085, 2, 320x180 
0x1BF21730, 37561851414719384, 66494215, 66494217, 2, 320x180 
0x1BF21730, 37561851416152464, 66494354, 66494362, 8, 320x180 
0x1BF21730, 37561851417432992, 66494481, 66494484, 3, 320x180 
0x1BF21730, 37561851418717176, 66494614, 66494617, 3, 320x180 
0x1BF21730, 37561851420472080, 66494787, 66494792, 5, 320x180 
0x1BF21730, 37561851421433000, 66494881, 66494884, 3, 320x180 
0x1BF21730, 37561851422715152, 66495009, 66495011, 2, 320x180 
0x1BF21730, 37561851424312488, 66495173, 66495176, 3, 320x180 
0x1BF21730, 37561851425432528, 66495285, 66495287, 2, 320x180 
0x1BF21730, 37561851426716888, 66495411, 66495413, 2, 320x180 
0x1BF21730, 37561851428312888, 66495571, 66495574, 3, 320x180 
0x1BF21730, 37561851429665560, 66495706, 66495709, 3, 320x180 
0x1BF21730, 37561851430718176, 66495812, 66495815, 3, 320x180 
0x1BF21730, 37561851432312448, 66495969, 66495971, 2, 320x180 
0x1BF21730, 37561851433432416, 66496082, 66496084, 2, 320x180 
0x1BF21730, 37561851434715664, 66496210, 66496213, 3, 320x180 
0x1BF21730, 37561851436312632, 66496372, 66496375, 3, 320x180 
0x1BF21730, 37561851437754944, 66496517, 66496519, 2, 320x180 
0x1BF21730, 37561851438714712, 66496613, 66496616, 3, 320x180 
0x1BF21730, 37561851440313032, 66496769, 66496772, 3, 320x180 
0x1BF21730, 37561851441592312, 66496900, 66496904, 4, 320x180 
0x1BF21730, 37561851442715024, 66497011, 66497013, 2, 320x180 
0x1BF21730, 37561851444312424, 66497169, 66497171, 2, 320x180 
0x1BF21730, 37561851445592536, 66497298, 66497300, 2, 320x180 
0x1BF21730, 37561851446715736, 66497414, 66497416, 2, 320x180 
0x1BF21730, 37561851448313480, 66497569, 66497571, 2, 320x180 
0x1BF21730, 37561851449598936, 66497702, 66497704, 2, 320x180 
0x1BF21730, 37561851450714400, 66497811, 66497814, 3, 320x180 
0x1BF21730, 37561851452312384, 66497970, 66497972, 2, 320x180 
0x1BF21730, 37561851453593456, 66498097, 66498099, 2, 320x180 
0x1BF21730, 37561851455032544, 66498243, 66498245, 2, 320x180 
0x1BF21730, 37561851456312408, 66498369, 66498371, 2, 320x180 
0x1BF21730, 37561851457593000, 66498499, 66498501, 2, 320x180 
0x1BF21730, 37561851458873328, 66498628, 66498630, 2, 320x180 
0x1BF21730, 37561851460312608, 66498769, 66498772, 3, 320x180 
0x1BF21730, 37561851461593120, 66498901, 66498905, 4, 320x180 
0x1BF21730, 37561851462873152, 66499025, 66499027, 2, 320x180 
0x1BF21730, 37561851464312264, 66499174, 66499176, 2, 320x180 
0x1BF21730, 37561851465592408, 66499301, 66499304, 3, 320x180 
0x1BF21730, 37561851466872848, 66499424, 66499428, 4, 320x180 
0x1BF21730, 37561851468312288, 66499570, 66499572, 2, 320x180 
0x1BF21730, 37561851469592952, 66499701, 66499704, 3, 320x180 
0x1BF21730, 37561851470873184, 66499826, 66499828, 2, 320x180 
0x1BF21730, 37561851472312368, 66499968, 66499970, 2, 320x180 
0x1BF21730, 37561851473592432, 66500101, 66500103, 2, 320x180 
0x1BF21730, 37561851474872256, 66500229, 66500231, 2, 320x180 
0x1BF21730, 37561851476153720, 66500353, 66500356, 3, 320x180 
0x1BF21730, 37561851477593648, 66500502, 66500507, 5, 320x180 
0x1BF21730, 37561851478877640, 66500630, 66500633, 3, 320x180 
0x1BF21730, 37561851480152600, 66500756, 66500759, 3, 320x180 
0x1BF21730, 37561851481592272, 66500899, 66500901, 2, 320x180 
0x1BF21730, 37561851482874456, 66501027, 66501029, 2, 320x180 
0x1BF21730, 37561851484152360, 66501154, 66501160, 6, 320x180 
0x1BF21730, 37561851485592616, 66501297, 66501299, 2, 320x180 
0x1BF21730, 37561851486872632, 66501425, 66501428, 3, 320x180 
0x1BF21730, 37561851488152248, 66501554, 66501557, 3, 320x180 
0x1BF21730, 37561851489593568, 66501698, 66501700, 2, 320x180 
0x1BF21730, 37561851490872688, 66501828, 66501830, 2, 320x180 
0x1BF21730, 37561851492152576, 66501955, 66501957, 2, 320x180 
0x1BF21730, 37561851493436624, 66502087, 66502092, 5, 320x180 
0x1BF21730, 37561851494873488, 66502228, 66502230, 2, 320x180 
0x1BF21730, 37561851496152808, 66502357, 66502363, 6, 320x180 
0x1BF21730, 37561851497432856, 66502484, 66502487, 3, 320x180 
0x1BF21730, 37561851498875352, 66502630, 66502632, 2, 320x180 
0x1BF21730, 37561851500152392, 66502752, 66502754, 2, 320x180 
0x1BF21730, 37561851501433976, 66502884, 66502887, 3, 320x180 
0x1BF21730, 37561851502878208, 66503029, 66503031, 2, 320x180 
0x1BF21730, 37561851504152680, 66503157, 66503161, 4, 320x180 
0x1BF21730, 37561851505432608, 66503284, 66503286, 2, 320x180 
0x1BF21730, 37561851506872712, 66503429, 66503432, 3, 320x180 
0x1BF21730, 37561851508152336, 66503556, 66503559, 3, 320x180 
0x1BF21730, 37561851509434728, 66503685, 66503687, 2, 320x180 
0x1BF21730, 37561851510719168, 66503813, 66503817, 4, 320x180 
0x1BF21730, 37561851512152512, 66503957, 66503966, 9, 320x180 
0x1BF21730, 37561851513433352, 66504082, 66504084, 2, 320x180 
0x1BF21730, 37561851514717072, 66504213, 66504215, 2, 320x180 
0x1BF21730, 37561851516152016, 66504353, 66504355, 2, 320x180 
0x1BF21730, 37561851517739944, 66504514, 66504516, 2, 320x180 
0x1BF21730, 37561851518712952, 66504609, 66504611, 2, 320x180 
0x1BF21730, 37561851520152136, 66504755, 66504758, 3, 320x180 
0x1BF21730, 37561851521432624, 66504885, 66504888, 3, 320x180 
0x1BF21730, 37561851522715912, 66505015, 66505017, 2, 320x180 
0x1BF21730, 37561851524152536, 66505155, 66505159, 4, 320x180 
0x1BF21730, 37561851525432872, 66505284, 66505286, 2, 320x180 
0x1BF21730, 37561851527038160, 66505445, 66505448, 3, 320x180 
0x1BF21730, 37561851528152360, 66505552, 66505555, 3, 320x180 
0x1BF21730, 37561851529434368, 66505685, 66505688, 3, 320x180 
0x1BF21730, 37561851530713168, 66505810, 66505813, 3, 320x180 
0x1BF21730, 37561851532472608, 66505987, 66505990, 3, 320x180 
0x1BF21730, 37561851533432800, 66506083, 66506085, 2, 320x180 
0x1BF21730, 37561851535037480, 66506244, 66506247, 3, 320x180 
0x1BF21730, 37561851536312864, 66506369, 66506374, 5, 320x180 
0x1BF21730, 37561851537432648, 66506482, 66506484, 2, 320x180 
0x1BF21730, 37561851538715400, 66506611, 66506614, 3, 320x180 
0x1BF21730, 37561851540312440, 66506768, 66506770, 2, 320x180 
0x1BF21730, 37561851541432416, 66506884, 66506886, 2, 320x180 
0x1BF21730, 37561851542713464, 66507011, 66507013, 2, 320x180 
0x1BF21730, 37561851544312896, 66507169, 66507172, 3, 320x180 
0x1BF21730, 37561851545435056, 66507285, 66507287, 2, 320x180 
0x1BF21730, 37561851546714928, 66507413, 66507415, 2, 320x180 
0x1BF21730, 37561851548312120, 66507574, 66507576, 2, 320x180 
0x1BF21730, 37561851549752456, 66507713, 66507715, 2, 320x180 
0x1BF21730, 37561851550719104, 66507814, 66507817, 3, 320x180 
0x1BF21730, 37561851552312696, 66507968, 66507971, 3, 320x180 
0x1BF21730, 37561851553594152, 66508101, 66508104, 3, 320x180 
0x1BF21730, 37561851554714320, 66508215, 66508218, 3, 320x180 
0x1BF21730, 37561851556312496, 66508370, 66508381, 11, 320x180 
0x1BF21730, 37561851557600432, 66508499, 66508501, 2, 320x180 
0x1BF21730, 37561851558713936, 66508611, 66508617, 6, 320x180 
0x1BF21730, 37561851560312656, 66508772, 66508778, 6, 320x180 
0x1BF21730, 37561851561592792, 66508899, 66508901, 2, 320x180 
0x1BF21730, 37561851563035520, 66509046, 66509049, 3, 320x180 
0x1BF21730, 37561851564313152, 66509172, 66509177, 5, 320x180 
0x1BF21730, 37561851565593040, 66509297, 66509299, 2, 320x180 
0x1BF21730, 37561851567034440, 66509446, 66509448, 2, 320x180 
0x1BF21730, 37561851568313120, 66509574, 66509576, 2, 320x180 
0x1BF21730, 37561851569592832, 66509697, 66509699, 2, 320x180 
0x1BF21730, 37561851570875264, 66509825, 66509827, 2, 320x180 
0x1BF21730, 37561851572312760, 66509970, 66509973, 3, 320x180 
0x1BF21730, 37561851573592992, 66510097, 66510100, 3, 320x180 
0x1BF21730, 37561851574873024, 66510226, 66510228, 2, 320x180 
0x1BF21730, 37561851576312912, 66510374, 66510380, 6, 320x180 
0x1BF21730, 37561851577592448, 66510497, 66510500, 3, 320x180 
0x1BF21730, 37561851578874664, 66510628, 66510630, 2, 320x180 
0x1BF21730, 37561851580312376, 66510774, 66510780, 6, 320x180 
0x1BF21730, 37561851581592712, 66510897, 66510900, 3, 320x180 
0x1BF21730, 37561851582875800, 66511029, 66511031, 2, 320x180 
0x1BF21730, 37561851584312800, 66511172, 66511175, 3, 320x180 
0x1BF21730, 37561851585592496, 66511298, 66511300, 2, 320x180 
0x1BF21730, 37561851586873928, 66511428, 66511430, 2, 320x180 
0x1BF21730, 37561851588152448, 66511554, 66511557, 3, 320x180 
0x1BF21730, 37561851589592472, 66511696, 66511698, 2, 320x180 
0x1BF21730, 37561851590873256, 66511828, 66511830, 2, 320x180 
0x1BF21730, 37561851592152328, 66511958, 66511965, 7, 320x180 
0x1BF21730, 37561851593592928, 66512101, 66512104, 3, 320x180 
0x1BF21730, 37561851594873024, 66512226, 66512229, 3, 320x180 
0x1BF21730, 37561851596151944, 66512358, 66512361, 3, 320x180 
0x1BF21730, 37561851597592728, 66512498, 66512500, 2, 320x180 
0x1BF21730, 37561851598876536, 66512627, 66512629, 2, 320x180 
0x1BF21730, 37561851600152400, 66512757, 66512762, 5, 320x180 
0x1BF21730, 37561851601592456, 66512901, 66512904, 3, 320x180 
0x1BF21730, 37561851602877664, 66513030, 66513032, 2, 320x180 
0x1BF21730, 37561851604152832, 66513156, 66513159, 3, 320x180 
0x1BF21730, 37561851605432904, 66513283, 66513285, 2, 320x180 
0x1BF21730, 37561851606874648, 66513427, 66513430, 3, 320x180 
0x1BF21730, 37561851608152800, 66513556, 66513560, 4, 320x180 
0x1BF21730, 37561851609432976, 66513681, 66513683, 2, 320x180 
0x1BF21730, 37561851610872696, 66513830, 66513832, 2, 320x180 
0x1BF21730, 37561851612152448, 66513952, 66513954, 2, 320x180 
0x1BF21730, 37561851613432568, 66514083, 66514086, 3, 320x180 
0x1BF21730, 37561851614872448, 66514228, 66514230, 2, 320x180 
0x1BF21730, 37561851616152544, 66514356, 66514359, 3, 320x180 
0x1BF21730, 37561851617433008, 66514482, 66514484, 2, 320x180 
0x1BF21730, 37561851618872320, 66514629, 66514631, 2, 320x180 
0x1BF21730, 37561851620152872, 66514757, 66514763, 6, 320x180 
0x1BF21730, 37561851621432928, 66514882, 66514884, 2, 320x180 
0x1BF21730, 37561851622712840, 66515010, 66515013, 3, 320x180 
0x1BF21730, 37561851624152768, 66515157, 66515163, 6, 320x180 
0x1BF21730, 37561851625433136, 66515283, 66515285, 2, 320x180 
0x1BF21730, 37561851626716128, 66515410, 66515412, 2, 320x180 
0x1BF21730, 37561851628152624, 66515555, 66515563, 8, 320x180 
0x1BF21730, 37561851629432480, 66515684, 66515686, 2, 320x180 
0x1BF21730, 37561851630712992, 66515811, 66515814, 3, 320x180 
0x1BF21730, 37561851632152544, 66515953, 66515956, 3, 320x180 
0x1BF21730, 37561851633433120, 66516082, 66516084, 2, 320x180 
0x1BF21730, 37561851635035296, 66516246, 66516248, 2, 320x180 
0x1BF21730, 37561851636152432, 66516355, 66516358, 3, 320x180 
0x1BF21730, 37561851637432784, 66516482, 66516484, 2, 320x180 
0x1BF21730, 37561851639036344, 66516645, 66516647, 2, 320x180 
0x1BF21730, 37561851640472040, 66516788, 66516791, 3, 320x180 
0x1BF21730, 37561851641432424, 66516884, 66516886, 2, 320x180 
0x1BF21730, 37561851642712936, 66517009, 66517011, 2, 320x180 
0x1BF21730, 37561851644312400, 66517169, 66517171, 2, 320x180 
0x1BF21730, 37561851645432704, 66517284, 66517286, 2, 320x180 
0x1BF21730, 37561851646717560, 66517415, 66517417, 2, 320x180 
0x1BF21730, 37561851648313488, 66517569, 66517576, 7, 320x180 
0x1BF21730, 37561851649439128, 66517683, 66517686, 3, 320x180 
0x1BF21730, 37561851650714736, 66517814, 66517817, 3, 320x180 
0x1BF21730, 37561851652312376, 66517969, 66517982, 13, 320x180 
0x1BF21730, 37561851653432592, 66518083, 66518085, 2, 320x180 
0x1BF21730, 37561851654714424, 66518213, 66518215, 2, 320x180 
0x1BF21730, 37561851656313536, 66518372, 66518378, 6, 320x180 
0x1BF21730, 37561851657754504, 66518519, 66518528, 9, 320x180 
0x1BF21730, 37561851658714256, 66518614, 66518616, 2, 320x180 
0x1BF21730, 37561851660312480, 66518770, 66518772, 2, 320x180 
0x1BF21730, 37561851661592880, 66518900, 66518902, 2, 320x180 
0x1BF21730, 37561851662712904, 66519010, 66519012, 2, 320x180 
0x1BF21730, 37561851664312800, 66519174, 66519181, 7, 320x180 
0x1BF21730, 37561851665592456, 66519302, 66519306, 4, 320x180 
0x1BF21730, 37561851666713256, 66519410, 66519412, 2, 320x180 
0x1BF21730, 37561851668312976, 66519572, 66519575, 3, 320x180 
0x1BF21730, 37561851669593152, 66519697, 66519700, 3, 320x180 
0x1BF21730, 37561851671035080, 66519843, 66519845, 2, 320x180 
0x1BF21730, 37561851672312576, 66519973, 66519976, 3, 320x180 
0x1BF21730, 37561851673592680, 66520099, 66520101, 2, 320x180 
0x1BF21730, 37561851675036696, 66520244, 66520247, 3, 320x180 
